~<BLANK>
3M - 3M
A AMER - ACER AMERICAN CORPORATION
A CHAL - ALLIS CHALMERS
A TOUR - AMERICAN TOURISTER
AGFA - AGFA
AIRLIN - AIRLINE (MANUFACTURED FOR MONTGOMERY WARD)
ALPINE - ALPINE
AMANA - AMANA
AMF - AMF
APPLE - APPLE
B DECK - BLACK AND DECKER
B LOMB - BAUSCH AND LOMB
B STRA - BRIGGS &AMP; STRATTON
BASSET - BASSETT
BAUER - BAUER
BERNIA - BERNIA
BISSEL - BISSELL
BORLAN - BORLAND
BOSCH - BOSCH
BRADFO - BRADFORD (MANUFACTURED FOR W. T. GRANT)
BROTHE - BROTHER
BSR - BSR
BURTON - BURTON
BUSHNE - BUSHNELL
C INLI - CCM INLINES
C M SY - COLORADO MEMORY SYSTEMS
C MAST - CHANNEL MASTER
C MATH - CURTIS MATHES
C PRO - CALIFORNIA PRO
CANON - CANON
CARRIE - CARRIER
CASIO - CASIO
COBRA - COBRA
COMMOD - COMMODORE
CRAFTS - CRAFTSMAN
D MINT - DANBURY MINT
DAEWOO - DAEWOO
DELTA - DELTA
DICTAP - DICTAPHONE
DONRUS - DONRUSS
DREMEL - DREMEL
DYNAST - DYNASTAR
DYNO - DYNO
E KODA - EASTMAN KODAK
ELECTR - ELECTROPHONIC
ELF - ELF
ELGIN - ELGIN (LORD OR LADY)
EMERSO - EMERSON
ENESCO - ENESCO
EPSON - EPSON
EUREKA - EUREKA
FARBER - FARBERWARE
FISHER - FISHER
FRANKL - FRANKLIN
FRIGID - FRIGIDAIRE
FUJITS - FUJITSU
G 2000 - GATEWAY 2000
G ELEC - GENERAL ELECTRIC
GAF - GAF
GARMIN - GARMIN
GARRAR - GARRARD
GOLDST - GOLDSTAR
GORMAN - GORMAN
GT - GT
GUCCI - GUCCI
H BEAC - HAMILTON BEACH
H PACK - HEWLETT-PACKARD COMPANY
HILTI - HILTI
HITACH - HITACHI
HOOVER - HOOVER
HUFFY - HUFFY
HUMMEL - HUMMEL
HUSQVA - HUSQVARNA
HYUNDA - HYUNDAI
IBM - IBM (INTERNATIONAL BUSINESS MACHINES)
IMPULS - IMPULSE
J C PE - J. C. PENNEY
J DEER - JOHN DEERE
J MESS - JOHNSON MESSENGER
JACUZZ - JACUZZI
JVC - JVC
K 2 - K-2
K LOCK - KWICK-LOCK
K MART - K MART
KAZAZ - KAZAZ
KEMPER - KEMPER
KENMOR - KENMORE
KITCHE - KITCHENAID
KONICA - KONICA
L BOY - LAWN BOY
L C SM - L. C. SMITH
L J ST - LEAR JET STEREO, INC.
LANIER - LANIER
LINCOL - LINCOLN
LIONEL - LIONEL
LITTON - LITTON
LLADRO - LLADRO
M BENZ - MERCEDES-BENZ
M ELEC - MICRON ELECTRONICS, INC.
M FALL - MILLERS FALLS
M N SO - MOUNTAIN NETWORK SOLUTIONS, INC.
M WARD - MONTGOMERY WARD AND CO.
MAGELL - MAGELLAN
MAGNAV - MAGNAVOX
MAKITA - MAKITA USA, INC.
MARANT - MARANTZ
MATCO - MATCO
MAYTAG - MAYTAG
MCCULL - MCCULLOCH
MICROS - MICROSOFT
MIDLAN - MIDLAND
MINOLT - MINOLTA
MITSUB - MITSUBISHI
MONGOO - MONGOOSE
MOTORO - MOTOROLA
MURATA - MURATA
N TRAC - NORDICTRACK
NCR - NCR (NATIONAL CASH REGISTER CO.)
NEC - NEC
NIKON - NIKON
NINTEN - NINTENDO
NORDIC - NORDICA
NOVELL - NOVELL
P ASAH - PENTAX ASAHI
P BELL - PACKARD BELL
P BOWE - PITNEY BOWES
P FORM - PRO FORM
PANASO - PANASONIC
PARKPR - PARKPRE
PEERLE - PEERLESS
PENNCR - PENNCREST (MANUFACTURED FOR J. C. PENNEY)
PENTAX - PENTAX
PFAFF - PFAFF
PHILCO - PHILCO
PIONEE - PIONEER
POLARO - POLAROID
PORSCH - PORSCHE
POWERL - POWERLITE
PRINCE - PRINCE CORPORATION
QUASAR - QUASAR
R RAND - REMINGTON RAND
RAICHL - RAICHLE
RAINBO - RAINBOW
RAMSET - RAMSET
RAYBAN - RAYBAN
RCA - RCA (RADIO CORPORATION OF AMERICA)
REMING - REMINGTON
RICOH - RICOH
ROBINS - ROBINSON
ROCES - ROCES
ROLEX - ROLEX
ROLLER - ROLLERBLADE
ROSSIG - ROSSIGNOL
RUBBER - RUBBERMAID
RYAN - RYAN
RYOBI - RYOBI
S CORO - SMITH CORONA
S ROEB - FREE SPIRIT (BICYCLE MODEL OF SEARS, ROEBUCK &AMP; CO.)
S ROEB - SEARS, ROEBUCK &AMP; CO.
S TOOL - SNAP-ON TOOLS
SALOMO - SALOMON
SAMSON - SAMSONITE
SAMSUN - SAMSUNG
SANBOR - SANBORN
SANSUI - SANSUI
SANYO - SANYO
SCHWIN - SCHWIN
SEGA - SEGA
SEIKO - SEIKO
SHARP - SHARP
SHREDD - SHREDDER
SILVER - SILVERTONE (MANUFACTURED FOR SEARS, ROEBUCK &AMP; CO.)
SINGER - SINGER
SKIL - SKIL CORPORATION
SNAPPE - SNAPPER
SONY - SONY
STANLE - STANLEY
STIHL - STIHL
SWIFT - SWIFT
SYLVAN - SYLVANIA
SYMAN - SYMANTEC
T INST - TEXAS INSTRUMENTS
TECHNI - TECHNICS
TECUMS - TECUMSEH
THOMAS - THOMASVILLE
TIMEX - TIMEX
TONKA - TONKA
TOPPS - TOPPS
TORO - TORO
TOSHIB - TOSHIBA
TRANE - TRANE
U DECK - UPPER DECK
U S RO - U.S. ROBOTICS
U WHEE - ULTRA-WHEELS
UNIDEN - UNIDEN
USDA - U.S. DEPARTMENT OF AGRICULTURE (FOOD STAMPS)
VIVITA - VIVITAR
W AUTO - WESTERN FLYER (WESTERN AUTO)
W ELEC - WESTERN ELECTRIC
WESTIN - WESTINGHOUSE
WHIRLP - WHIRLPOOL
WORDPE - WORDPERFECT
XEROX - XEROX
YAMAHA - YAMAHA
YASHIC - YASHICA
ZENITH - ZENITH
ZEOS - ZEOS
