~<BLANK>
DCIRCUI - ACCELERATOR BOARD
MACCORD - ACCORDION
OACCOUN - ACCOUNTING MACHINE
RACTUAT - ACTUATOR, ANTENNA
EADAPTO - ADAPTOR
OADDING - ADDING MACHINE
OADDRES - ADDRESSING MACHINE
EAIRBRS - AIR BRUSH
ECOMPRE - AIR COMPRESSOR
EAIRCOM - AIR COMPRESSOR ACCESSORIES (NOT OTHERWISE CODED)
HAIRCON - AIR CONDITIONER
EACCHGS - AIR CONDITIONING CHARGING SYSTEM
EAIRFIL - AIR FILE (TOOL)
EAIRHAN - AIR HANDLING UNIT
HAIRPUR - AIR PURIFIER
EAIRWRN - AIR RATCHET WRENCH
ERATCHE - AIR RATCHET/AIR WRENCH
ESPADER - AIR SPADER
JAIRTIC - AIRLINE TICKET
EALARM - ALARM
QALIEN - ALIEN REGISTRATION CARD OR GREEN CARD (PHC)
IALIEN - ALIEN REGISTRATION, GREEN, PERMANENT RESIDENT CARD OR PERMANENT VISA
EAMMETE - AMMETER
RAMPLIF - AMPLIFIER
EANALYZ - ANALYZER
EANGLE - ANGLE
LCOLLAR - ANIMAL IDENTIFICATION COLLAR/TAG
OANSWER - ANSWERING MACHINE
RANTENN - ANTENNA
EARCSMS - ANTENNA & AMP; RADAR CROSS SECTION MEASUREMENT SYSTEM
EAPNMON - APNEA MONITOR
SSCUBA - AQUALUNG
EWELDER - ARC WELDER
GARCADE - ARCADE GAME (INCLUDES COIN OPERATED)
OATMMAC - ATM MACHINE
EATTENU - ATTENUATOR
RCDISC - AUDIO DISC, COMPACT
RENHANC - AUDIO ENHANCER/STABILIZER
RAUDIOE - AUDIO EQUIPMENT AND ACCESSORIES (NOT OTHERWISE CODED)
RPROCES - AUDIO PROCESSOR
RATAPE - AUDIO TAPE (ALL TYPES)
RSWITCH - AUDIO/VIDEO SWITCHER
RCDPLAY - AUDIO/VIDEO/LASER PLAYERS
EAUDIOM - AUDIOMETER
EAUGER - AUGER/POST HOLE DIGGER
CWINDER - AUTO WINDER FOR CAMERA
MAUTOHA - AUTOHARP
DCONTRO - AUTOMATIC CONTROLLER
EREGULA - AUTOMATIC CONTROLLER/REGULATOR
EAUTOPI - AUTOMATIC PILOT
OTAPEDI - AUTOMATIC TAPE DISPENSER
ODIALER - AUTOMATIC TELEPHONE DIALER
JSTICKE - AUTOMOBILE INSPECTION STICKER
EAUTOMO - AUTOMOTIVE (NOT OTHERWISE CODED)
EVESCTO - AUTOMOTIVE DIAGNOSTIC SCAN/SCAN TOOL
EDIAGSC - AUTOMOTIVE DIAGNOSTIC SCANNER
PBCKPCK - BACKPACK
IBADGE - BADGE/SHEILD
QBADGE - BADGE/SHEILD (PHC)
OBANKBA - BAG, BANK/MONEY
MBAGPIP - BAGPIPES
WBAILER - BAILER (INCLUDES CLEANOUT)
EBALANC - BALANCER
EWHEELB - BALANCER, WHEEL
SBALL - BALL
MBANJO - BANJO
KBULLIO - BAR (GOLD OR SILVER)
DBARCOD - BAR CODE KIT
MBARITO - BARITONE
EBAROME - BAROMETER
MBASS - BASS
MBASSOO - BASSOON
HBTHTUB - BATHTUB
ECHARGE - BATTERY (PACK, CHARGER, RECHARGER)
EBATCHG - BATTERY CHARGER, AUTOMOBILE
RPOWERP - BATTERY PACK, RECHARGEABLE
DPOWERP - BATTERY, RECHARGEABLE
SBBGUN - BB GUN
EPULLER - BEARING PULLER
FBED - BED
MBELLS - BELLS, MARCHING BAND OR ORCHESTRA
SBENCH - BENCH EXERCISE/INCLINE
FBENCH - BENCH, OTTOMAN, STOOL
BBICYCL - BICYCLE
SRACK - BICYCLE RACK
BSHOCKS - BICYCLE SHOCKS
BBICYCT - BICYCLE TRAILER (TRAILER ATTACHMENT FOR BICYCLE)
GPOOLTA - BILLIARD TABLE
EBINDER - BINDER
VBINOCU - BINOCULARS
TBIOLOG - BIOLOGICAL
LBIRD - BIRD
JBIRTHC - BIRTH CERTIFICATE
EBIT - BIT
WBIT - BIT, WELL DRILLING
EBLADE - BLADE (BLADES NOT OTHERWISE CODED)
HBLENDE - BLENDER
WBLOCK - BLOCK, CROWN/TRAVELING
EBLOWER - BLOWER
WBLOWOU - BLOWOUT PREVENTER
SSLANTB - BOARD, SLANT
EBOLTCU - BOLT CUTTER
KBOOK - BOOK COLLECTOR/RARE
FBOOKCA - BOOKCASE
RPOWERB - BOOSTER, POWER
SBOW - BOW
HSILVER - BOWL (SILVER)
RCABLEC - BOX, CABLE TV CONVERTER
PBRACEL - BRACELET
PHABRAC - BRACELET, HOUSE ARREST
EBRAKE - BRAKE
EBREAKE - BREAKER
EBRTANL - BREATH ANALYZER/TESTER
PCASE - BRIEF/ATTACHE CASE
DINTERF - BUFFER/INTERFACE MODULE
EBUGLIG - BUG LIGHT (ZAPPER)
MBUGLE - BUGLE
PVEST - BULLETPROOF VEST
EBLTPRF - BULLETPROOF VEST/BODY ARMOR
DEXTEND - BUS EXTENDER (USED TO BOOST DATA TRANSMISSION)
DDOCSCN - BUSINESS CARD READER
FCABINE - CABINET, BUFFET, CREDENZA, SIDEBOARD (EXCLUDING FILING)
OFILECA - CABINET, FILE
ECABLE - CABLE
DCABLE - CABLE (TELECOMMUNICATION)
ECABLEL - CABLE LOCATOR
RCABLEL - CABLE TV LASHER
OCALCUL - CALCULATOR
ECALIBR - CALIBRATOR
ECALIPE - CALIPER/MICROMETER
OCAIDB - CALLER ID BOX/UNIT
CCMCRDR - CAMCORDER
RCAMCOR - CAMCORDER
CCAMERA - CAMERA
CBACK - CAMERA BACK
CBODY - CAMERA BODY
CCASE - CAMERA CASE
CCMFLTR - CAMERA FILTER
CFILTER - CAMERA FILTER
CLENS - CAMERA LENS
CMOTORD - CAMERA MOTOR DRIVE
RVIDEOC - CAMERA, VIDEO
SCAMPG - CAMPING GEAR AND SUPPLIES (NOT OTHERWISE CODED)
HOPENER - CAN OPENER
OVENDIN - CANDY MACHINE
PCAPE - CAPE
PCHLDST - CAR (CHILD) SEAT
QCREDEN - CARD, FEDERAL OR POLICE IDENTIFICATION (PHC)
DCCSCAN - CARD/DOCUMENT READER/SCANNER (CREDIT CARD, PASSPORT, DOCUMENTS, ETC.)
ECARDIO - CARDIOGRAPH
ECRPTOL - CARPET KNEE KICKER/POWER STRETCHER
HSTEAMC - CARPET/STEAM/SPOT CLEANER RUG/CARPET SHAMPOOER (INCLUDING ATTACHMENTS WITH AN UNIQUE SERIAL OR OAN NUMBER)
DCASE - CARRYING CASE FOR PORTABLE COMPUTER (PC)
RCASE - CARRYING CASE FOR VIDEO EQUIPMENT
OCART - CART
DTAPE - CARTRIDGE TAPE (BLANK, ENCODED)
RCARTRI - CARTRIDGE, STEREO TONE ARM
MCASE - CASE, MUSICAL INSTRUMENT
OCASHRE - CASH REGISTER
WCUTTER - CASING CUTTER
WROLLER - CASING ROLLER
RCOMBO - CASSETTE PLAYER COMBINATION/RADIO/COMPACT DISC PLAYER
OCASTIN - CASTING MACHINE
LFELINE - CAT
WCATHEA - CATHEAD (BREAKOUT & AMP; MAKEUP)
DCRT - CATHODE RAY TUBE/CRT
LCATTLE - CATTLE
WCATWOR - CATWORK
ESEAGUN - CAULKING GUN
RCDRECO - CD RECORDER
DCDROMD - CD-ROM DRIVE
DDPLCTR - CD-ROM DUPLICATOR
DCELLPH - CELL PHONE/SMARTPHONE AND ACCESSORIES
MCELLO - CELLO MUSICAL INSTRUMENT
ECMIXER - CEMENT MIXER
DCPU - CENTRAL PROCESSING UNIT (CPU)
JGIFTCE - CERTIFICATE, GIFT
ECHAINS - CHAIN SAW
FCHAIR - CHAIR, MASSAGE THERAPY, RECLINER
PCHALIC - CHALICE
OCHANGE - CHANGER, MONEY, BILL AND COIN
RCHANNE - CHANNEL SELECTOR
OCHECKW - CHECK PROTECTOR
PCHDLST - CHILD RESTRAINT SEAT
ECHISEL - CHISEL
ECHRONO - CHRONOMETER
PLIGHTE - CIGARETTE LIGHTER, E-CIGARETTE
RCBRADI - CITIZENS BAND (CB) RADIO
MCLARIN - CLARINET
ECLIPPE - CLIPPERS
FCLOCK - CLOCK
HDRYER - CLOTHES DRYER
HWASHER - CLOTHES WASHER/WASHING MACHINE/WASHER
PCOAT - COAT
FCOATRA - COAT RACK/TREE
HCOFFEE - COFFEE, ESPRESSO, CAPPUCCINO MAKER/MACHINE
EACCOIL - COIL FOR AIR CONDITIONING UNIT
KCOIN - COIN SETS (COMMERATIVE/COLLECTOR)
KCOLLEC - COLLECTIBLE (NOT OTHERWISE CODED)
KMODEL - COLLECTIBLE MINIATURE REPLICA MODEL
ECOMPAC - COMPACTOR
ETAMPER - COMPACTOR, CONSTRUCTION
ECOMPAS - COMPASS
OTYPEWR - COMPOSER
OCOMPTO - COMPTOGRAPH
DCONSOL - COMPUTER CONSOLE
DSTAND - COMPUTER EQUIPMENT STAND
DCMPHRD - COMPUTER HARDWARE (NOT OTHERWISE CODED)
DCMRHRD - COMPUTER HARDWARE (NOT OTHERWISE CODED)
DHANDCO - COMPUTER ONLY HAND HELD CONTROLS (FOR GAME CONTROLS SEE CATEGORY G (GAMES))
DSERVER - COMPUTER SERVER
DSPEAKE - COMPUTER SPEAKERS
DSPEKRS - COMPUTER SPEAKERS
DTERMIN - COMPUTER TERMINAL
ECONDEN - CONDENSER
OCONTAI - CONTAINER, STORAGE (NOT SHIPPING)
WVALVEC - CONTROL VALVE
RHANDCO - CONTROL, VIDEO HAND HELD
ECONTRO - CONTROLLER
RVCONVE - CONVERTER
RFMCONV - CONVERTER, FM
ECONVEY - CONVEYOR
OWATERC - COOLER, WATER
OCOPIER - COPY MACHINE
MCORNET - CORNET
TCORROS - CORROSIVE
FCOUCH - COUCH, DAVENPORT, LOVESEAT, SETTEE, SOFA
ECOUNTE - COUNTER
ECOUPLE - COUPLER
JFSCOUP - COUPON, FOOD STAMP
SSKIMAC - CROSS COUNTRY SKI MACHINE
RCROSSO - CROSSOVER (FOR STEREO SYSTEM)
PCUFFLN - CUFFLINKS
ETILLER - CULTIVATOR/ROTOTILLER
ECUTTER - CUTTER (NOT OTHERWISE CODED)
ETORCH - CUTTING TORCH
GVRGLAS - CYBER SHADES
SECYCLE - CYCLE, EXERCISE
MCYMBAL - CYMBAL
DDIGIT - DATA TABLET, DIGITIZER
RTAPEDE - DECK, TAPE (DECK ONLY)
DTELETE - DECODER MODULE, TELETEXT
EDEFIBR - DEFIBRILLATOR
HDEHUMI - DEHUMIDIFIER
EDEBOWL - DENTAL BOWL
EHANDPI - DENTAL HANDPIECE
EDEPTHF - DEPTHFINDER (ALSO INCLUDES FATHOMETERS)
RDESCRA - DESCRAMBLER (DECODES SATELLITE SIGNALS)
FDESK - DESK
DPRINTE - DESK JET PRINTER
DCOMPUT - DESKTOP/PERSONAL COMPUTER
PDIAMON - DIAMOND
ODICTAT - DICTATING MACHINE
EDIESET - DIE TOOL SET
CDIGCAM - DIGITAL CAMERA
RDELAY - DIGITAL DELAY PROCESSOR
RDMMDEV - DIGITAL MULTIMEDIA DEVICE (NOT OTHERWISE CODED)
DDIGPRO - DIGITAL PR0JECT0R (REQUIRES C0MPUTER C0NNECTI0N)
RDIGREC - DIGITAL SATELLITE SYSTEM AND ACCESSORIES (NOT OTHERWISE CODED)
RDVRECO - DIGITAL VIDE0 REC0RDER
RDIRECT - DIRECTION FINDER, RADIO
HDISHWA - DISHWASHER
DDRIVES - DISK DRIVES
DDISK - DISK, COMPUTER (HARD, FLOPPY)
RVDISK - DISK, VIDEO
DDOCSTA - DOCKING STATION FOR ELECTRONIC DEVICES
LDOG - DOG
QDOGTAG - DOG TAG (MILITARY ID) (PHC)
IDOGTAG - DOG TAG/MILITARY ID
KDOLL - DOLL
EDOOROP - DOOR OPENER, GARAGE
EDOPPLR - DOPPLER FETAL HEART RATE MONITOR
EDOSIME - DOSIMETER
ODRAFTI - DRAFTING MACHINE
WDRAWWO - DRAWWORKS
WDRILL - DRILL (ROCK AND BLASTHOLE)
WCOLLAR - DRILL COLLARS
EDRILLP - DRILL PRESS/VERTICAL DRILL/BENCH DRILL
WMILL - DRILL, PIPE MILL
EDRILL - DRILL/DRIVER
IDRIVER - DRIVER'S LICENSE
EDRONE - DRONES/UNMANNED AERIAL VEHICLE (OVER .55 LBS REFERENCE THE VEHICLE FILE VMA/AERO VMO/DRN VST/DN)
MDRUM - DRUM
PDRYER - DRYER, HAIR
CDRYER - DRYER, PHOTO
EDUMPT - DUMPSTER
RDVCOMB - DVD VCR COMBO
EDWELLM - DWELL METER
DEMACHI - E MACHINE (DEVICE FOR SENDING E MAIL)
PEARRIN - EARRINGS
ESONAR - ECHO SOUNDER/FISH FINDER/SONAR
EEDGER - EDGER/ROTARY EDGER
CEDITOR - EDITOR, FILM OR VIDEO TAPE
EEEGMCH - EEG MACHINE
HHNDMXR - ELECTRIC HAND MIXER
ESNAKE - ELECTRIC SNAKE/SEWER CLEANER
EPOWERS - ELECTRICAL (NOT OTHERWISE CODED)
EEKGMCH - ELECTROCARDIOGRAM MACHINE
DELCDCT - ELECTRONIC DICTIONARY
DELCENC - ELECTRONIC ENCYCLOPEDIA
GELGAME - ELECTRONIC GAME (NOT OTHERWISE CODED)
DCMMIDI - ELECTRONIC MUSICAL INSTRUMENT-DIRECT COMPUTER INTERFACE (MIDI)
DELCORG - ELECTRONIC ORGANIZER
DEREADR - ELECTRONIC READER (E-READER)
DELCSPL - ELECTRONIC SPELLER
RTVGAME - ELECTRONIC TELEVISION GAME
LEMU - EMU
EENGINE - ENGINE, NONVEHICLE (POWERED BY FUEL)
EENGRAV - ENGRAVER
CENLARG - ENLARGER
OENVMCH - ENVELOPE MACHINE
TEPAHAZ - ENVIROMENTAL PROTECTION AGENCY ENVIROMENTAL PROTECTION AGENCY S
JSUMMON - ENVIRONMENTAL SUMMONS
DEPROMP - EPROM PROGRAMMER
EEQUALI - EQUALIZER (EQUIPMENT NOT STEREO/SOUND)
REQUALI - EQUALIZER (STEREO/SOUND EQUIPMENT)
EEVAPOR - EVAPORATOR
RRANGEE - EXPANDER, RANGE
EEXPLOS - EXPLOSIVES
TEXPLOS - EXPLOSIVES
CLIGHTM - EXPOSURE METER
DFAXMOD - EXTERNAL FAX MODEM
VEYEGLA - EYEGLASSES, EYEGLASS FRAMES
OFAX - FACSIMILE TRANSIEVER
HFAN - FAN
LFERRET - FERRET
MVIOLIN - FIDDLE
KFIGURI - FIGURINE/DOLL
EFILE - FILE
CMAGAZI - FILM MAGAZINE
EFILTER - FILTER
DFINGSC - FINGERPRINT SCANNER (HANDHELD / PORTABLE)
EFINISH - FINISHING MACHINE
EFIREEX - FIRE EXTINGUISHER
SFISHIN - FISHING GEAR AND SUPPLIES (NOT OTHERWISE CODED)
ILICENS - FISHING LICENSE
SFITEXR - FITNESS/EXERCISE EQUIPMENT
TFLALIQ - FLAMMABLE LIQUIDS
TFLASOL - FLAMMABLE SOLIDS
CFLASH - FLASH
EFLASHL - FLASH LIGHT
ENEONSN - FLASHING SIGN FOR ROADWORK
HBUFFER - FLOOR BUFFER/ROTARY FLOOR MACHINE/ELECTRIAL FLOOR SCRUBBER/FLOOR POLISHER
MFLUTE - FLUTE
OFOLDER - FOLDING MACHINE
HFOODPR - FOOD PROCESSOR
IFSCARD - FOOD STAMP CARD
HFDMXR - FOOD/HAND MIXER
EFORENS - FORENSIC KIT
HFREEZE - FREEZER
EFRNRCM - FREON/REFRIGERANT RECOVERY MACHINE
HFRYER - FRYER
PFUR - FUR, STOLE
HFURNAC - FURNACE
FHMFRNT - FURNITURE/FURNISHINGS (NOT OTHERWISE CODED)
EFUSE - FUSE
EFUSSPL - FUSION SPLICER
HDISPOS - GARBAGE DISPOSAL/DISPOSER
TGGASES - GAS
HGASFIR - GAS FIREPLACE
EGAUGE - GAUGE
EGEIGER - GEIGER COUNTER
PGEMSTO - GEM STONES
EGENERA - GENERATOR, NON-AUTOMOBILE
JGIFTCD - GIFT CARDS (PREPAID GIFT OR DEBIT CARDS)
DMOUSE - GLIDE POINT DESKTOP (POINT PAD)
EGPOSYS - GLOBAL POSITIONING SYSTEM (GPS) NAVIGATION SYSTEM
LGOAT - GOAT
SGOLFCA - GOLF CART, NONMOTORIZED
SGOLFCL - GOLF CLUBS
DGRINDB - GRAPHIC INPUT DRAWING BOARD
HGRILL - GRILL
EGRINDE - GRINDING MACHINE/GRINDER
WRHGUID - GUIDE, RATHOLE
MGUITAR - GUITAR
IGUNLIC - GUN LICENSE/PERMIT
SHOMGYM - GYM, HOME
EGYROSC - GYROSCOPE
PHRSTYL - HAIRSTYLING TOOLS
EHAMMER - HAMMER/POWER HAMMER
EHHRADI - HAND HELD RADIO, POLICE
EHDTOOL - HAND TOOL (NOT OTHERWISE CODED)
EHANDTR - HAND TRUCK/DOLLY
GHANDCO - HAND/GAME CONTROLLER
PHANDCU - HANDCUFFS
DHNDHLD - HANDHELD DEVICE (NOT OTHERWISE CODED)
EHARDWA - HARDWARE (NOT OTHERWISE CODED)
MHARMON - HARMONICA
MHARP - HARP
PHAT - HAT
RHEADSE - HEADSET/EARPHONE
PHEARIN - HEARING AID
EHEARTM - HEART MONITOR
HHEATPU - HEAT PUMP
HSPACEH - HEATER, SPACE
EHEACOO - HEATING/COOLING (NOT OTHERWISE CODED)
EHEDGEC - HEDGE TRIMMER
PHELMET - HELMET
EHOE - HOE
EHOIST - HOIST/LIFT
EHOLSTE - HOLSTER
WHYDRAH - HOOK, HYDRA
MHORN - HORN
LEQUINE - HORSE (EQUINE)
EHORSER - HORSE RACING EQUIPMENT
SHORSEE - HORSE RIDING/RACING/TRAINING EQUIPMENT
HHOTTUB - HOT TUB
HAPPLNC - HOUSEHOLD APPLIANCES (NOT OTHERWISE CODED)
HHSWARE - HOUSEWARE (NOT OTHERWISE CODED)
HHUMIDI - HUMIDIFIER
SHUNTG - HUNTING GEAR AND SUPPLIES (NOT OTHERWISE CODED)
HICREMA - ICE CREAM MACHINE
HICEMAK - ICE MAKER/MACHINE
SISKATE - ICE SKATES
HREFRIG - ICEBOX/REFRIGERATOR
ICREDEN - IDENTIFICATION CARD/CREDENTIALS
OIMPRIN - IMPRINT MACHINE
SROLBLD - IN-LINE SKATES
EINDICA - INDICATOR
MSTAND - INSTRUMENT STAND
RINTERC - INTERCOM
HIRON - IRON
QOTHER - ITEMS OF IDENTIFICATION (PHC)
EJACK - JACK
PJACKET - JACKET
PJEWELR - JEWELRY (NOT OTHERWISE CODED)
STREADM - JOGGING MACHINE
WTOOLJO - JOINT TOOL
EJOINTE - JOINTER
DJOYST - JOYSTICK, COMPUTER
HJUICER - JUICER
RJUKEBO - JUKEBOX
RKARAOK - KARAOKE
KKPSAKE - KEEPSAKE (NOT OTHERWISE CODED)
WKELLYS - KELLY SPINNER
EKEY - KEY
EKEYMAK - KEY MAKING MACHINE
MKEYBOA - KEYBOARD (MUSICAL INSTRUMENT)
DKEYBOA - KEYBOARD, COMPUTER
DKEYPAD - KEYPAD, COMPUTER
DKEYPUN - KEYPUNCH MACHINE
WKSWIPE - KEYSEAT WIPER
HRANGE - KITCHEN STOVE/RANGE/OVEN
HKNIFE - KNIFE
ESHARPE - KNIFE SHARPENER
ELABEQU - LAB EQUIPMENT (NOT OTHERWISE CODED)
OLABELE - LABELER
ELADDER - LADDER
ELAMINA - LAMINATING MACHINE
FLAMP - LAMP
OTELEPH - LANDLINE TELEPHONE
EMOWER - LANDSCAPE/LAWN MOWER
OLANGUA - LANGUAGE TEACHING MACHINE
SLANTER - LANTERN
DLAPTOP - LAPTOP/NOTEBOOK COMPUTER
ELASER - LASER DEVICES
ELMDEVI - LASER MEASURING DEVICES
SLASGUN - LASER TAG GUN
ELATHE - LATHE
ELAWENF - LAW ENFORCEMENT EQUIPMENT (NOT OTHERWISE CODED)
ELEAFBL - LEAF BLOWER
ELKDTCT - LEAK DETECTOR
OLECTER - LECTERN
SLEGMAC - LEG DEVELOPING MACHINE
ELEVEL - LEVEL
JLICTAB - LICENSE PLATE RENEWAL TAB
QLICENS - LICENSE, FISHING OR HUNTING (PHC)
QDRIVER - LICENSE, MOTORCYCLE OPERATORS OR PILOTS OR CHAUFFEURS OR DRIVERS (PHC)
ELIFEPR - LIFE PRESERVER
ELIFT - LIFT
DLIGHTP - LIGHT, PEN
DLINEFI - LINE FILTER OR PROTECTOR
DPWRPRT - LINE POWER/PROTECTION DEVICE
ELOCK - LOCK
PLOCKET - LOCKET
ELOGSPL - LOG SPLITTER
ELORAN - LONG RANGE NAVIGATION UNIT (LORAN)
GLOTMAC - LOTTERY MACHINE
JLOTTER - LOTTERY TICKET
PLUGGAG - LUGGAGE
ETEARGA - MACE
GPINBAL - MACHINE, PINBALL
RPROMPT - MACHINE, PROMPTING
SROWING - MACHINE, ROWING
GSLOTMA - MACHINE, SLOT
ENEWSRA - MAGAZINE/NEWS STAND RACK
OMAILIN - MAILING MACHINE
MMANDOL - MANDOLIN
HMNDOLN - MANDOLIN (KITCHEN TOOL)
PMASSAG - MASSAGER
EMEASUR - MEASURING DEVICE (NOT OTHERWISE CODED)
PMEDALL - MEDALLION
EMEDICA - MEDICAL EQUIPMENT (NOT OTHERWISE CODED)
EMEGOHM - MEGOHMMETER
MMELLOP - MELLOPHONE
DMEMORY - MEMORY MODULE/BOARD
EMETALD - METAL DETECTOR
OPOSTAG - METER, POSTAGE
DREADER - MICROFICHE READER
EMICROM - MICROMETER
RMICROP - MICROPHONE
VMICROS - MICROSCOPE
HOVEN - MICROWAVE OVEN
EMILLIN - MILLING MACHINE
EMITERB - MITER BOX
RLGTMXR - MIXER, LIGHT
RSOUNDM - MIXER, SOUND
DMODEM - MODEM
DMODM - MODEM, COMPUTER (INTERNAL OR EXTERNAL)
OMOMACH - MONEY ORDER/ADD VALUE MACHINE COMPUTERIZED DEVICES
RMONITO - MONITOR
PMORBOX - MORTUARY BOX (USED TO HOLD CREMATED HUMAN REMAINS.)
PMORURN - MORTUARY URN (RECEPTACLE TO HOLD CREMATED HUMAN REMAINS.)
EMOTOR - MOTOR (POWERED BY ELECTRICITY/PNEUMATIC)
WMPTANK - MUD PIT TANK
EMULTIM - MULTI-METER/VOM (VOLT-OHM METER OR VOLT-OHM-MILLIAMMETER)
DDOCSYS - MULTIFUCTIONIAL ALL-IN-ONE PRINTER
DMLTPRS - MULTIMEDIA PRESENTER
DMULTIP - MULTIPLEXOR
OMULTIP - MULTIPLIER
RVMULTI - MULTIPLIER, VIDEO
MINSTRU - MUSICAL INSTRUMENT (NOT OTHERWISE CODED)
MMSCASE - MUSICAL INSTRUMENT CASE
MMSCKEY - MUSICAL INSTRUMENT KEYBOARD
DPIANO - MUSICAL INSTRUMENT-DIRECT COMPUTER INTERFACE
ESTUDGU - NAIL GUN/NAILER
ENAVIGA - NAVIGATION METER
PNECKLA - NECKLACE
RNEEDLE - NEEDLE, STEREO (EXCLUDES CARTRIDGE)
ENRVSTM - NERVE STIMULATION UNIT
DNETWRK - NETWORKING HARDWARE/NETWORKING EQUIPMENT/COMPUTER NETWORKING DEVICES
ENIBBLE - NIBBLER
VNGTVSG - NIGHT VISION GOGGLES
FNGTSTN - NIGHTSTAND/BEDSIDE TABLE
PNGTSTC - NIGHTSTICK
RNOISER - NOISE REDUCTION UNIT
MOBOE - OBOE
QLAPELP - OFFICIAL DETAIL LAPEL PIN (PHC)
EOHMMET - OHMMETER
OORDRMA - ORDERING MACHINE
MORGAN - ORGAN
KCARPET - ORIENTAL CARPET/RUG
EOSCILL - OSCILLOSCOPE
EOUTEQP - OUTDOOR EQUIPMENT (NOT OTHERWISE CODED)
EOXIMET - OXIMETER
WPACKER - PACKER
JPRESCR - PAD, PRESCRIPTION
RPAGER - PAGER/BEEPER
ESPRAYE - PAINT SPRAYER/SPRAY GUN
EPSTRPR - PAINT STRIPPER
KPAINTI - PAINTING
SPARACH - PARACHUTE
EPARKME - PARKING METER
JPERMIT - PARKING PERMIT/HANDICAP PLACARD (HANDICAP LIC PLATES PUT IN THE LIC PLATE FILE)
IPASSPO - PASSPORT
QPASSPO - PASSPORT (PHC)
VPERISC - PERISCOPE
PPSNLAC - PERSONAL ACCESSORIES (NOT OTHERWISE CODED)
DPDASSI - PERSONAL DIGITAL ASSISTANT/ELECTRONIC ORGANIZER
QPINCAR - PERSONAL IDENTIFICATION NUMBER CARD (PHC)
IPINCAR - PERSONAL INDENTIFICATION (PIN) CARD % DO NOT ENTER ATM/BANK CARDS. THIS CODE WILL BE DELETED 1/1/2019
JPHONEC - PHONE/CALLING CARD
RPHONOG - PHONOGRAPH (MONO)
RSTEREO - PHONOGRAPH (STEREO)
CPHTTLS - PHOTOGRAPHY TOOLS AND EQUIPMENT (NOT OTHERWISE CODED)
MPIANO - PIANO
MPICCOL - PICCOLO
LSWINE - PIG
WPLPIG - PIG, PIPELINE
LPIGEON - PIGEON
PPIN - PIN (JEWELRY)
EPIPETH - PIPE THREADING MACHINE
EDRLEQP - PIPELINING/WELL DRILLING EQUIPEMENT (NOT OTHERWISE CODED)
EPLANE - PLANE
EPLANER - PLANER (POWER TOOL)
KPLATE - PLATE (COLLECTOR SIGNED, NUMBERED)
HPLATE - PLATE (NOT OTHERWISE CODED)
RTAPEPL - PLAYER, TAPE (PLAYS ONLY)
EPLIERS - PLIERS
EPLOW - PLOW
TPOISON - POISONOUS SUBSTANCES
EPOLLGT - POLICE CRUISER MINI-BAR (LIGHTS ON TOP OF POLICE CRUISERS.)
GPCSTIC - POOL CUE STICK
HPOPCOR - POPCORN MAKER
DDGTMED - PORTABLE DIGITAL MEDIA PLAYER (MP3 PLAYERS/IPODS)
DPRTRMV - PORTABLE DRIVE/REMOVABLE DISK
ETOILET - PORTABLE TOILET/PORTA POTTIES
OVALIDA - POST OFFICE VALIDATION PLATE
EPOST - POST-HOLE DIGGER
OPOSTIN - POSTING MACHINE
EINVERT - POWER INVERTER/INVERTER
EPOWERP - POWER PACK
EPRRAKE - POWER RAKE/DETHATCHER
DCMPPSU - POWER SUPPLY UNIT (PSU)
DPOWERS - POWER SUPPLY, COMPUTER
EPSWEEP - POWER SWEEPER, OUTDOOR
WTONG - POWER TONG
EPWTOOL - POWER TOOL (NOT OTHERWISE CODED)
ETROWEL - POWER TROWEL/FLOAT/TROWEL MACHINE
RPREAMP - PREAMPLIFIER
EPRESS - PRESS
EWATERB - PRESSURE/POWER WASHER
KPRINT - PRINT (ART)
RVPRINT - PRINTER, VIDEO STILL
EPROBE - PROBE
CSCREEN - PROJECTION SCREEN
CPROJEC - PROJECTOR MOVIE/SLIDE
JTITLE - PROPERTY TITLE
RPASYST - PUBLIC ADDRESS SYSTEM
EPUMP - PUMP
WPUMPUN - PUMPING UNIT
EPUNCH - PUNCH
PPURSE - PURSE
EPYROME - PYROMETER
LRABBIT - RABBIT (ANIMAL)
SRACKET - RACKET
EDETECT - RADAR DETECTOR
ERADAR - RADAR/RADAR GUN
RRADIO - RADIO
EXTRMNT - RADIO FREQUENCY HEAT APPLICATION SYSTEM
EMETER - RADIO TELEMETRY SYSTEM
ETLMTRY - RADIO TELEMETRY SYSTEM
RRADITA - RADIO(AM/FM)/TAPE PLAYER, COMBINATION
RRADICD - RADIO/COMPACT DISC PLAYER,COMBINATION
RRADIOR - RADIO/RECORD PLAYER, COMBINATION
RRADIOT - RADIO/TELEVISION, COMBINATION
RRTVREC - RADIO/TELEVISION/RECORD PLAYER, COMBO
ERAKE - RAKE
CRANGEF - RANGE FINDER
HHOOD - RANGE/EXHAUST HOOD
PSHAVER - RAZOR (SHAVER)
WREAMER - REAMER, (ENLARGERS AND OPENERS)
EREBART - REBAR TIER
RRECEIV - RECEIVER
MRECORD - RECORDER (WOODWIND INSTRUMENT)
RTAPERE - RECORDER, TAPE (RECORDS AND PLAYS)
SREEL - REEL
RREMOTE - REMOTE CONTROL
RRCPLNE - REMOTE CONTROL AIRPLANE
RRCBOAT - REMOTE CONTROL BOAT
RRCCAR - REMOTE CONTROL CAR
RRCTRCK - REMOTE CONTROL TRUCK
SRCTOY - REMOTE/RADIO CONTROL TOYS
KREPLIC - REPLICA/MODEL/ART PRINTS
ERESPIR - RESPIRATOR
ERESUSC - RESUSCITATOR
RREVERB - REVERBERATOR
PRING - RING
ERIVETG - RIVET GUN
SRSKATE - ROLLER SKATES
EROLLER - ROLLER, HAND-HELD
WDRILLU - ROTARY TABLE, DRILLING UNIT
EROUTER - ROUTER
DROUTER - ROUTER (WIRELESS / COMPUTER)
HSHAMPO - RUG SHAMPOOER
OSLIDER - RULER, SLIDE
SSADDLE - SADDLE
OSAFE - SAFE
ESANDBL - SANDBLASTER
ESANDER - SANDER
RSATDSH - SATELLITE DISH
ESAW - SAW
MSAXOPH - SAXOPHONE
ESCAFFO - SCAFFOLDING/STAGING
ESCALES - SCALES
RSCANNE - SCANNER
HSCISSO - SCISSORS
SSCOOTE - SCOOTER
VSCOPE - SCOPE (GUN OR TELESCOPE)
ESCREWG - SCREW GUN/SCREWDRIVER
ESCREWD - SCREWDRIVER/SCREW GUN
ESCRUBB - SCRUBBER
SSEASCO - SEA SCOOTER
ESEISMG - SEISMOGRAPH
ESENSOR - SENSOR
ESEPARA - SEPARATOR
ESEWERC - SEWER CLEANER
HSEWING - SEWING MACHINE
ESEXTAN - SEXTANT
WSSHAKE - SHAKER, SHALE
ESHEARS - SHEARS
LSHEEP - SHEEP
WSHOCK - SHOCK
ESHOVEL - SHOVEL
ESHREDD - SHREDDER (PAPER, ETC.)
JSIGN - SIGN
SSKATEB - SKATE, BOARD/ICE/IN-LINE/ROLLER
SSKIS - SKIS
ESLICER - SLICER
HMEATSL - SLICING MACHINE/DELI SLICER/SLICER/MEAT SLICER
ISMARTC - SMART CARD
QSMARTC - SMART CARD (PHC)
ESMOKED - SMOKE ALARM
ESNOWBL - SNOW BLOWER
ESNOWPL - SNOW PLOW (NONRIDING)
SSBOARD - SNOWBOARD
ISSCARD - SOCIAL SECURITY CARD
QSSCARD - SOCIAL SECURITY CARD (PHC)
ESOCKET - SOCKET SET
ESODCUT - SOD CUTTER
DSFTWRE - SOFTWARE
ESOLARC - SOLAR ENERGY
ESOLARP - SOLAR PANEL, SUN TRACKER
ESOLDER - SOLDERING GUN
MSOUSAP - SOUSAPHONE
RSPEAKE - SPEAKERS
DSPEECH - SPEECH SYNTHESIZER (VOICE)
ESPHYGM - SPHYGMOMANOMETER
WSPIDER - SPIDER/PIPE SUPPORT
WSPINWR - SPINNING WRENCH
SSPORTS - SPORTS EQUIPMENT (NOT OTHERWISE CODED)
ESPOTLI - SPOTLIGHT
ESPRAYG - SPRAY GUN
ESPREAD - SPREADER
ESPRINK - SPRINKLER
WSTABIL - STABILIZER
JSTAMP - STAMP (EXCLUDING FOOD STAMP)
OSTAMPM - STAMP MACHINE
RSTAND - STAND, VIDEO EQUIPMENT
ESTAPLE - STAPLE GUN/POWERED STAPLER
SBCYCLE - STATIONARY EXERCISE BICYCLE
OSTENCI - STENCIL MACHINE
OSTENOT - STENOTYPE
SSTPEXM - STEP-EXERCISE MACHINE
RSTFPLT - STEREO FACE PLATE
RRACK - STEREO RACK SYSTEM
ESTETHO - STETHOSCOPE
SSTOPWA - STOP WATCH/CLOCK
ETANK - STORAGE TANK
DSTREAM - STREAMING DEVICE
ESTROBE - STROBE OR MIXER LIGHT
PSTRLLR - STROLLER
WSUB - SUB (KICK, SHEAR, PIN, ETC.)
SSURFBO - SURFBOARD
ESWITCH - SWITCH (ALL TYPES)
WSWIVEL - SWIVEL, POWER
SSWORD - SWORD
MSYNTHE - SYNTHESIZER
FTABLE - TABLE
GGMTBLE - TABLE TOP & MULTI-GAME TABLE
DTABLET - TABLET COMPUTER, MOBILE COMPUTER USUALLY WITH A TOUCHSCREEN OR PEN-ENABLED INTERFACE
OTABULA - TABULATING MACHINE/UNIT RECORD EQUIPMENT/ELECTRIC ACCOUNTING
ETACHMT - TACHOMETER
JTMPRSS - TAMPER-RESISTANT SECURITY PAPER
ETAPER - TAPE MACHINE, AUTOMATIC
ETAPEME - TAPE MEASURE
RVTAPE - TAPE, VIDEO
ETATTOO - TATTOO MACHINE
OTELREC - TELERECORDER
DTELETY - TELETYPEWRITER
RTELEVI - TELEVISION
RTELDVD - TELEVISION/DVD COMBINATION
RTELVCR - TELEVISION/VIDEO CASSETTE RECORDER,COMBINATION
STENT - TENT
ETESTER - TESTER
ETHEODO - THEODOLITE
ETHERMO - THERMOMETER
ETHERMS - THERMOSTAT
ETHREAD - THREADER
DTHUMBD - THUMB DRIVE
JTICKET - TICKET (NOT OTHERWISE CODED)
ETIMECL - TIME CLOCK
ETIMER - TIMER
ETIMING - TIMING LIGHT
HTOASTE - TOASTER
HTSTOVN - TOASTER OVEN
HTOILET - TOILET, PORTABLE/STANDARD (ALL TYPES)
ETONGS - TONGS
ETONOME - TONOMETER
ETOOLBO - TOOLBOX
TTORM - TOXIC CHEMICAL
KSCARDS - TRADING CARDS/BASEBALL CARDS
ETRAFFI - TRAFFIC CONTROL/ROAD CONSTRUCTION DEVICES/TRAFFIC COUNTER
RTRANSC - TRANSCEIVER
OTRANSC - TRANSCRIBER
ETRANSD - TRANSDUCER
ETRANSF - TRANSFORMER
ETRANSI - TRANSIT THEODOLITE
RTRANSM - TRANSMITTER
ETRANSP - TRANSPONDER
HTRASHB - TRASH BARREL/TRASH OR GARBAGE CAN
HCOMPAC - TRASH COMPACTOR
HTRSHCM - TRASH COMPACTOR
JMTPASS - TRAVEL PASS; BUS, TRAIN, SUBWAY, MASS TRANSIT, EZ
STREEST - TREE STAND
ETRENCH - TRENCHER/DITCH WITCH
ETRIMME - TRIMMER/CIPPERS/SHEARS/SCISSORS
CTRIPOD - TRIPOD
MTROMBO - TROMBONE
MTRUMPE - TRUMPET
MTUBA - TUBA
RTUNER - TUNER
RTURNTA - TURNTABLE
OTYPESE - TYPESETTER
MUKULEL - UKULELE
EULTRS - ULTRA SOUND MACHINE
PUNIFOR - UNIF0RM
HVACATT - VACUUM CLEANER ATTACHMENTS (UNIQUE SERIAL OR OAN NUMBER)
HVACUUM - VACUUM CLEANER/SWEEPER/ELECTRIC BROOM (INCLUDING ATTACHMENTS WITH AN UNIQUE SERIAL OR OAN NUMBER)
EVALVE - VALVE
WVALVE - VALVE, WELL-DRILLING
FVASE - VASE (NON-COLLECTOR)
KVASE - VASE, COLLECTOR
EVIBRAT - VIBRATOR TOOL/CONCRETE VIBRATOR
RVCRWN - VIDEO CASSETTE REWINDER
RVIDEOD - VIDEO PLAYER/RECORDER STATIONARY/PORTABLE AND ACCESSORIES (NOT OTHERWISE CODED)
RVIDEOR - VIDEO RECORDER
RVIDEOT - VIDEO TUNER/TIMER
VVIEWER - VIEWER
CVIEWFI - VIEWFINDER
MVIOLA - VIOLA
EVISE - VISE
RVOICEC - VOICE CONTROL UNIT
DVOICER - VOICE RECOGNITION DEVICE (NOT FOR CELL PHONES) AMAZON ECHO, GOOGLE HOME
OVOICEW - VOICEWRITER
EVOLTME - VOLTMETER
RWALKIE - WALKIE TALKIE/HAND-HELD RADIO
PWALLET - WALLET
WWASHOE - WASHOVER/ROTARY SHOE
FWASTEB - WASTEBASKET
PWATCH - WATCH
HWATERH - WATER HEATER/HOT WATER TANK
HSOFTEN - WATER SOFTENER/FILTRATION/PURIFICATION SYSTEM
SWTRSPR - WATER SPORTS GEAR AND SUPPLIES (NOT OTHERWISE CODED)
EWATTME - WATTMETER
DSWATCH - WEARABLE DEVICES/ACTIVITY TRACKERS
RWEBTV - WEB TV
EWEEDER - WEED CUTTER/WEED EATER
PWHEELC - WHEELCHAIR, NONMOTORIZED
EWINCH - WINCH
EWINDRK - WINDSHIELD REPAIR KIT (MOBILE DEVICE TO REPAIR WINDSHIELDS)
SSNOWGR - WINTER/SNOW SPORTS GEAR AND SUPPLIES (NOT OTHERWISE CODED)
EWIREST - WIRE STRIPPER
DWIRREC - WIRELESS RECEIVER (WIRELESS AIRCARD OR RECEIVER FOR PDA'S, COMPUTERS AND OTHER HANDHELD COMPUTING DEVICES)
EWOODSH - WOOD SHAPER
HWOODST - WOODBURNING STOVE/WOOD BURNER
DWORDPR - WORD PROCESSOR
EWRENCH - WRENCH
EXRAY - X-RAY EQUIPMENT
MXYLOPH - XYLOPHONE
HYGRTMC - YOGURT MACHINE
