~<BLANK>
AAA - WES-CO. BOATS DIVISION
AAI - ADAMS ENTERPRISES
AAK - TREND MFG.CO.OF AMERICA, INC JACKSONVILLE, FL
AAL - ATLANTIC BOAT WORKS BOOTHBAY, ME
AAN - SAMPSON MARINE
AAV - SNEAK, THE INC.
AAY - DOWNEAST YACHTS, INC.
ABH - ATLANTIC BOAT CO.INC BROOKLIN, MAINE DUFFY & DUFFY CUSTOM YACHTS AND FLYE POINT CORP MERGED TO BECOME ATLANTIC BOAT CO. INC.
ABM - APOLLO BOAT MFG. CO.
ABV - COM-PAC YACHTS CLEARWATER, FLORIDA
ABW - ATLANTIC BOAT WORKS
ACB - ALUMACRAFT BOAT CO. ARKADELPHIA, AR
ACF - ARCHERCRAFT BOATS
ACH - ACHILLES KCI CORP.
ACJ - NAUSET MARINE, INC; ORLEANS, MASSACHUSETTS
ACL - ACTION MARINE CHICAGO, IL
ACM - ACTION MARINE INC. (ACTION BOATS) HOLLYWOOD, FL
ACT - A. C. INTERFACE INC RANCHO SANTA MAR,CA
ACW - A. C. MFG. CO.
ADD - KIDD MARINE SALES
ADK - ATLANTIC BOAT WORKS HULL, MA
ADL - ALINDALE MFG., INC.
ADO - ANDRUS BOATS
AEC - YOUNG BROTHERS CO., INC.
AEG - AARDAL BOATS
AEQ - AIRLINE EQUIPMENT & SERVICE INC.
AER - AMERICAN MARINE ENGINEER
AFC - AMERICAN FIBERGLASS CO.
AFD - AIRBOAT ENGINEERING
AFF - AMERICAN FIBERGLASS
AFG - AMERICAN FIBER-LITE; MARION,IL AMERICAN FIBERGLASS
AFQ - ACTION CRAFT CAPE CORAL FLORIDA ADDED COASTLINE NAME 12/95 ADDED NEWPORT NAME (ASSIGNED MIC/NPX)FOR NEWPORT LINE
AGB - PHANTOM BOATS (AERO-GLASS BOAT CO.)
AGC - AEROGLASTICS, INC. BAJA BOAT CO. & SIERRA BOAT CORP
AGH - APPLEGARTH MARINE YARD
AGR - AVENGER MANUFACTURING CO.HARVEY, LA
AHE - APACHE AIRBOATS, INC.
AHN - SCOOTER BOATS
AHQ - THUNDER JET BOATS
AIL - MAVERICK SPORTBOATS W.COLUMBIA, SC
AIR - AIRE INC%MERIDIAN IDAHO
AIW - ALCORT SAILBOATS, INC. WATERBURY, CT
AKD - ABILITIES N S INC BEVERLY HILL, CA
AKG - AUGIE'S MARINE SERVICE POMPANO BEACH, FL
AKM - ANSWER MARINE INC; MIAMI, FLORIDA (OUT OF BUSINESS AS MIC/CTL WHICH WAS PREVIOUS MIC CODE) BACK IN BUSINESS
AKR - ANACAPRI MARINE
AKZ - ALASKA HOMEMADE BOATS
ALD - ALADDIN MFG. CO. YAZOO BOATS
ALL - ALLISON CRAFT BOAT CO.
ALS - ALL SEASONS INDUSTRIES
ALT - ALLISON CRAFT BOATS LOUISVILLE, TN
ALX - AL GROVERS MARINE BASS
ALZ - ALABAMA HOMEMADE BOATS
AMF - AMF ALCORT WATERBURY, CT
AMI - ARIMA MARINE INTERNATIONAL AUBURN, WASHINGTON
AMN - ALBIN MARIN AB-SWEDEN SAILBOATS,CATAMARANS, TRIMARANS
AMQ - AMERICAN MULTI-CRAFT
AMS - AMERCIAN SPORT BOAT MFG. INC LEXINGON, KY
AMX - AMERICAN MARINER INDS
ANF - MERICAN SAIL INC (AQUA CAT, INC.) CHARLESTON, SC
ANG - ANGLER BOAT CORP.
ANP - ANCHOR INDUSTRIES, INC. STERNCRAFT BOAT CO & DECKBOAT CORP.
ANT - ANTHONY BOAT CO.
AOD - ADVANTAGE POWER YACHTS
AOL - ARNOLD INDUSTRIES
APB - APPLEBY MFG. CO. CURRENTLY THE AINT PERFECT BOAT CO., NC
APG - APOLLO BOATS BOUNTIFUL, UT
APH - APACHE
API - AMERICAN PACIFIC INFLATABLES INC. TEMECULA, CA
APL - APOLLO BOATS, INC. CLEARWATER, FL
AQC - AQUA-CYCLE INTERNATIONAL, INC.
ARB - CATAMARAN CURISER DBA-COLUMBIA, TN PARENT COMPANY AMERICAN REDI-BUILT INC
ARI - ARLINGTON SPECIAL EDITIONS
ARJ - ARCTCO INC THIEF RIVER FALLS, MN ARCTIC CAT
ARK - ARKANSAS TRAVELER BOAT
ARR - ARROWCRAFT
ARV - ARROWHEAD YACHTS VINITA, OK
ARW - DAY MARINE, INC.DAY CO.& ARROW GLASS
ARZ - ARKANSAS HOMEMADE BOATS
ASB - AU SABLE VALLEY FIBERGLASS OSCADA, MICHIGAN
ASG - ACADEMY BROADWAY CORP.
ASH - ASHCRAFT BOAT CO.
ASK - ARIZONA SKI BOATS
ASM - ANDERSON SUNCOAST MARINE
ASP - AQUASPORT, INC.
ASR - ALL STAR
AST - ASTROGLASS BOATS (PRO CRAFT)
ATJ - ALCAR FIBERGLASS & BOAT CO.
ATL - ARISTO CRAFT BOAT CORP. ATLANTA BOAT WORKS
ATM - ATLANTIC BOAT WORKS CAMDEN, ME ATLANTIC STEAM WORKS
ATQ - ATLANTIC EASTERN CORP.
ATZ - ATTEX INTERNATIONAL AKRON, OH
AUH - ARTHUR ARMSTRONG INC KERNERSVILLE, NC OUT OF BUSINESS SEE MICDETAILS PAGE FOR ADDED INFO
AUL - ALBINE MARINE, INC COS COB CONNECTICUT OLDER ALBIN BOATS MAYMAY HAVE MIC/AUE. SOLD MOLDS FOR SMALL BOATS TO BLADEN COMPOSIT 
AVA - SEAMASTER MARINE
AVB - AVON RUBBER CO. SEAGULL MARINE IRVINE, CA BOUGHT BY ZODIAC 1998
AVC - ACTON FIBERGLASS, INC.
AVI - ADVANTAGE BOATS, INC.
AVL - AMERICAN LAMINATIONS TOMS RIVER, NEW JERSEY
AVN - ADVANCED MARINE CONCEPTS INC. AVENGER MFG. CO.INC.
AVP - AVANTI INDUSTRIES, INC.
AVY - ARRIVEE INC.
AWB - ALUMAWELD BOATS
AWL - ALWELD COMMERCIAL BOATS
AXC - SPIRIT MARINE ARCTIC ENTERPRISES
AXE - AQUA TERRA MFG. CO INDIANOLA, IA
AXT - AZTEC BOAT CORP.
AYR - AYR-WAY INDUSTRIES
AYY - AMSTERDAM BOAT WORKS SCOTIA, NEW YORK NAME CHANGE FROM 1.APPLELINE CO 2.ACRO INTERNATIONAL LTD (BOTH NOT PREVIOUSLY LISTED
AZA - R K BENTLEY & SONS NEWPORT BEACH, CA
AZZ - ARIZONA HOMEMADE BOATS
BAH - BAHNER CUSTOM BOATS, INC.
BAM - THUNDERBIRD PRODUCTS CORP. BROWNING AEROCRAFT MARINE
BAQ - BEAR AIRBOATS
BAR - BARRON BOATS, INC.
BAS - BASS CATS BOATS MOUNTAIN HOME, AR
BAV - BAVARIA YACHTS USA ANNAPOLIS, MD (TRADING TITLE) CHESAPEAKE HOLDINGS LLC IS IMPORTER
BBF - BRENTWOOD BOATWORKS COMPANY BRENTWOOD, NEW HAMPSHIRE MIC PREV ASSIGED TO DICK MILLER AND BAUMAN AKA-BAUMAN BROS & MILLER
BBK - BROOKS BOATS MT. DESERT, ME
BBQ - BROOKS FIBERGLASS CO.
BBU - BLUE BUOY YACHTS
BCB - B-CRAFT BOAT MFG. CO.
BCC - BEACHCRAFT MARINE
BCF - BEACH-CRAFT BOATS
BCF1 - BOICOURT MARINE
BCM - BAYCRAFT MARINE IRVINE, CA
BCP - BRENDELLA CUSTOM BOATS CURRENTLY KNOWN AS INTERNATIONAL INBOARD MARINE /PREV KNOWN AS SEVERAL DIFFERENT COMPANIES
BCT - BOAT CITY PAINT & BODY SHOP PENSACOLA, FL
BCZ - BUSTER BOAT CO.
BDB - D BLACKMANS BOAT SERVICE SAN DIEGO, CA
BDF - B & D FIBERGLASS, INC; ACTION, MASSACHUSETTS
BDG - BADGER BOAT BUILDERS COUDERWAY, WI
BEB - BEACON BOATS BRISTOL, RI
BEC - CMF BOATS
BEH - BERG BOATS, INC.
BEJ - BOB E. AYOU JR.CO COSTA MESA, CA
BEM - BEMIDJI BOAT CO., INC. CORE CRAFT CANOES
BER - WHITTAKER CORP. BERTRAM YACHT
BEY - BENETEAU USA INC SOUTH CAROLINA; FORMERLY BENETEAU USA, LTD
BEZ - BEZER BOATS LAKE HAVASU CITY, AZ
BFF - BLUE FIN INDUSTRIES, INC.
BFG - BROWNING F/G BOAT POWELL, TN
BFI - BURCHFIEL MFG.
BFP - BIFFY FIBERGLASS PRODUCTS ENCINTAS, CA
BHD - PLASTICS DIVISION OF INDUS ATLANTA, GA
BHH - FLYE POINT MARINE, INC. BROOKLIN, MAINE
BHS - BASS HOUND
BIA - ZEBRA MARINE
BID - BIDDISON DESIGNS, INC.
BIH - BRITANNIA BOATS ANNAPOLIS, MARYLAND
BIQ - BEATTY INDUSTRIES
BJC - DURKEE ENTERPRISES, INC BOJO BOAT CO
BKA - KOFFLER BOATS, EUGENE, OREGON
BKH - BASS HUNTER
BKT - BAKER CUSTOM BOATS
BKV - BAYMASTER BOATS INC LOS FRESNOS, TEXAS KRUGER BRAND BUYS OUT BCM BOATS
BL1 - BAYLINER MARINE, INC. PIPESTONE,MN
BL2 - BAYLINER MARINE, INC. VALDOSTA, GA
BL3 - BAYLINER MARINE, INC. SPOKANE, WA
BL4 - BAYLINER MARINE, INC. NEW BERN, NC
BL5 - BAYLINER MARINE, INC. SPOKANE, WA
BLB - BAYLINER MARINE, INC. SEATTLE, WA
BLP - BOMBER RAIDER
BLS - BLUE STAR MARINE CORP.
BLY - BAYOU BOATS
BMF - CREATIVE DYNAMICS, LLC NOANL,CONNECTICUT PREV ASSIGNED TO BURNS MFG / ALABAMA
BMH - BAY MARINE PLASTICS
BMR - BIESMEYER BOATS
BNB - BONAIR BOATS, INC.
BNE - BINDER & ASSOCIATES INC.
BNL - BROWNLOW MFG. CO.
BNM - BONANZA MOLDING CORP.
BNR - SKI WEST BOATS INC. MERCED, CA
BNS - BONS BATEAUX, THE
BNT - BONITO BOATS, INC. SOLD TO BENTLEY INDUSTRIES LLC _MIC/BNT ASSIGNED TO BENTLEY IND LLC 1/6/03
BNU - FORCE ENGINEERING
BNV - BYI, LTD. N.V.
BNZ - BENTZ CRAFT OLD HICKORY, TN
BOO - BOATS UNLIMITED GEORGETOWN, SC
BOT - BRADFORD BOATWORKS, INC.
BPC - BUCCANEER POWER BOATS
BQP - BRIDGES POINT BOAT YARD INC BROOKLIN, MAINE
BRA - BRYANT BOATS INC SWEET WATER, TN
BRB - BARNETT BOATS GREEN LAKE, WI
BRC - BRAMCO, INC.
BRCV - SEASWIRL BOATS
BRD - BROADBILL MAINE CORP.
BRO - BRACON INDUSTRIES, INC.
BRR - BURR BROTHERS BOATS INC MARION, MA
BRS - BURR SAILBOAT SAILS
BRU - SMYRNA SKIFFS INDIAN RIVER BOATS
BRW - HARWILL, INC. BROWNING MARINE DIV & AERO-CRAFT BOAT
BSD - BANSHEE INTERNATIONAL, INC.
BSM - BASSMASTER BOATS
BSV - J C MFG. INC. NORTH WEBSTER, IN
BTC - BALLISTIC BOATS FRUITLAND, IDAHO
BTD - B-CRAFT BOAT CO.
BTE - BRONTA BOAT CO., INC.
BTR - COTTON MOUTH IND. INC FRENCH SETTLEMENT, LA
BTY - CJ PEARSON CO C/O BRISTOL BRISTOL, RHODE ISLAND PARENT CO STIL IN BUSINESS; CJ PEARSON (INACTIVE)
BUG - PRECISION BURGESS ENT FAIRBANKS, AK
BUJ - BASS TRACKER CORP.
BUU - BASS TUB INC.
BVD - BREVARD BOAT WORKS (FLEETWING)
BVM - BANDIT MFG INC VIAN, OK
BWB - BROADWATER BOAT CO.
BWC - BOSTON WHALER, INC.
BWH - BLUE WATER BOAT WORKS
BWR - BARACUDA BOATS LONG BEACH, CA
BWV - B & W PLASTICS INC.
BWY - BLUE WATER BOATS
BWZ - BOWLAND MARINE
BXE - BELLCO BOATS, INC.
BXJ - BILLY SEABOLD RACING BOATS EAGLE BOATS, LTD
BYN - BAYRUNNER BOATS, INC WOODBINE, NJ
BZA - B & A DIST. COMPANY PORTLAND, OR
BZI - BUSH-WACKER BOAT, INC.
CAB - BANGOR PUNTA MARINE (CAL BOATS)
CAC - CAPE CODE SHIPBUILDING CO, WAREHAM, MASSACHUSETTS
CAL - CALIFORNIA BOAT MFG. CO.
CAQ - COLLETTES BOATING CENTER BREAUX BRIDGE LOUISIANA
CAR - CARGILE, INC.
CAT - CAROLINA CAT% NEW BERN, NC
CAU - CALKINS
CAV - CRITERION CO.INC; SWANSEA, MASSACHUSETTS
CBA - COBIA BOAT CO.
CBC - TEXAS MARINE INTERNATIONAL,INC CHRYSLER BOAT CORP.
CBM - CEE BEE MFG. CO. LYNWOOD, CA
CBT - CORSON BOAT CO MADISON, ME
CBW - CRANE BOAT WORKS; WAUPACA, WI PREV CENTRAL BOAT WORKS INC LA MARQUE,TX AND CUSTOM CRAFT; WISCONSIN BECAME CENTRAL BOAT WORKS
CBZ - CRAFT BOAT WORKS
CCA - CHRIS CRAFT ALGONAC, MI
CCB - CHRIS CRAFT SARASOTA, FL
CCC - CHRIS CRAFT BRADENTON, FL
CCD - CHRIS CRAFT
CCF - CHRIS CRAFT POMPANO, FL
CCH - CHRIS CRAFT
CCK - COLLINSCRAFT, INC.
CCM - HOBIE CAT (COAST CATAMARAN CORP.)
CCN - CHRIS CRAFT SWANSBORO, NC
CCR - CHRIS CRAFT ROAMER HOLLAND, MI
CCT - CHRIS CRAFT GALLIPOLIS, OH
CCU - CHRIS CRAFT FIUMICINO, ITALY
CCV - CHRIS CRAFT GOSHEN, IN
CCX - CRUISE BOATS, INC.
CCY - C & C YACHTS INC.
CDC - CRAIG CATAMARAN CORP. ORLANDO, FL
CDR - CARVER BOAT CORP. CABRAL BOATS
CEB - CENTURY BOAT CO.
CED - BLACKHAWK CANOE CO., INC.
CEE - CENTURIAN BOATS, INC.
CEH - COLORADO CUSTOM DESIGN, LTD.
CEM - COLE BOATS COLE MARINE
CER - THE C E RYDER CORP BRISTOL, RHODE ISLAND
CFD - CUSTOM FIBERGLASS PRODUCTS
CFS - COLUMBIA FIBERGLASS
CFT - CACCI CRAFT, INC.
CFY - COBRA MFG. CO.
CFZ - CALIFORNIA HOMEMADE BOATS
CGF - COLLINS CRAFT, INC.
CGH - ISLANDER MARINE WINTER GARDEN, FL
CGL - CROWN CUSTOM FIBERGLASS
CGM - GENERAL MARINE INDUSTRIES PANAMA CITY, FL
CGS - COMFORT USA; NORTHPORT, NEW YORK
CHA - COLORADO HEADWATERS,INC DENVER, COLORADO MIC/CHA WAS CHARGER MARINE
CHE - CHALLENGER BOAT, INC.CHALLENGER ENTERPRISES
CHJ - TRITON CUSTOM BOATS CHARGER CUSTOM BOATS
CHK - CHECKMATE BOATS, INC. BUCYRUS, OH
CHM - CRITCHFIELD MARINE, INC.
CHT - CHEETAH BOAT MFG., INC.
CIK - CHALLENGER BOAT WORKS ORLANDO, FL
CJC - CULVER-CHELLE, INC.
CJK - CALIFORNIA RIVERS GEYSERVILLE, CA
CJM - CHAPARREL MARINE PRODUCTS
CJR - CARRERA BOATS
CKB - CHEROKEE BOAT CO.
CKL - CONCORD BOAT CORP. SHERWOOD, AR
CKP - CAPE CRAFT LTD ST.JAMES CITY, FL
CLA - CLASSIC BOAT, CORP.
CLD - CALDWELL HIGH PERF. BOATS PASCO, WA
CLK - CLARK BOAT CO.
CLM - CLIPPER MARINE CORP.
CLZ - COLORADO HOMEMADE BOATS
CMA - CROSBY MARINE ENGR CORP.
CMN - CUSTOM MARINE SAVANNAH, GA
CMO - COUGAR MARINE, INC. N.MIAMI BEACH,FL
CMP - CAMP WAYS, INC.
CNE - CAROLINA BOAT CO.
CNH - CENTARK INDUSTRIES, INC.
CNO - CONROY INDUSTRIES
CNP - THE COLEMAN CO.INC. WICHITA, KS
CNT - CORONET BOATS OF NORTH AMERICA
COB - CLASSIC BOATS LINDENHURST, NY
COJ - COMMANDER BOATS
CON - HYUNDAI CORP.
COO - COOIBEE (NAVY CANOE)
COT - CATERPILLAR BOAT WORKS% BLUE HILL, ME (9/83 -8/86) NOW KNOWN AS CONTENDER MARINE INC,FL
COY - CYPRESS SHORES FABRIC FLORENCE, AL
CP2 - THE COLEMAN CO., INC. NEW BRAUNFELS, TX
CPA - CARRERA PERFORMANCE CRAFT; RIVERSIDE CA
CPD - CAPE DORY YACHTS INC E TAUTON MASSACHUSETTS; OOB 5/91 MOLDS & TOOLING SOLD TO NEWPORT SHIPYARDS CORP
CPG - CAMPAGNA FIBERGLASS
CPS - CAPRI SAILBOATS
CQB - CABO RICO YACHTS FORT LAUDERDALE, FLORIDA
CQK - CUDA CRAFT
CQR - CREATOR BOAT LA FOLLETTE, TENNESSEE
CQU - CUSTOM CRAFT UNLIMITED
CRJ - CERNE MARINE
CRL - AMF CRESTLINER CRESTLINER DIV.
CRO - ROBALO SPORT FISH BOAT
CRS - CRUISERS DIV. MIRRO MARINE DIV.
CRT - CIGARETTE RACING TEAM
CRW - CREWS CRAFT, INC.
CSB - CLASSIC BOAT, INC.
CSR - CORSAIR MARINE INC CHULA VISTA, CALIFORNIA
CST - COASTAL RECREATION (AQUARIUS DIV.OF LAGUNA YACHTS SAMUEL TEMPLE CUSTOM BOATS DIV OF COASTAL RECREATION
CTC - NAUTIQUE BOAT COMPANY INC%CODE PREV ASSIGNED TO CORRECT CRAFT INC,OUT OF BUSINESS PER USCG.CODE REASSIGNED
CTL - ANSWER MARINE (CONTINENTAL BOAT CO.) OUT OF BUSINESS UNDER MIC/CTL; BACK IN BUSINESS AS MIC/AKM-SEE NEW ENTRY (ANSWER MARINE
CTY - CATALINA YACHTS
CTZ - CONNECTICUT HOMEMADE BOATS
CUA - CUSTOM FIBERGLASS
CUB - CUB CRAFT
CUC - CUSTOM MARINE
CUE - CATALINA BOAT MFG.
CUO - CONTENDER CUSTOM BOATS
CUP - CUSTOM MARINE VALLEJO, CA
CUS - CUSTOM BOAT MFG CO ST. BERNARD, LA
CUY - CONDOR CUSTOM BOATS
CVB - CARAVELLE BOAT CO.
CVO - CAVALIER BOATS, INC.
CWJ - COLOSO BOAT CORP.
CWX - STORM BOATS IND. INC. POMPANO, FL
CXN - CRUSADER CUSTOM BOATS
CXR - CRITCHFIELD AND FROBOS MARINA
CYG - CELEBRITY BOATS INC.
CYV - COBRA BOAT MFG., INC.
CZB - CONDOR BOATS
DAA - BAUTECK MARINE CORP. ST. AUGUSTINE, FL
DAQ - DAGGER CANOE COMPANY HARRIMAN, TN
DAW - DAWSON BOAT CO.
DBJ - DELTA DIVE BOATS INC. CAPE CANAVERAL, FL
DBW - DARGEL BOAT WORKS DONNA, TX
DCB - DEM-CRAFT BOAT CO.
DCE - DAVES CUSTOM YACHTS EL CAJON, CALIFORNIA; ACQUIRED MOLDS FROMELIMINATOR (ELB) ALSO DAVES CUSTOM BOATS
DCF - DIALCRAFT BOATS
DCH - SOUTH BAY DUCK BOATS
DCI - DICK CLARKE, INC.
DCJ - DOYLE CRAFT
DCM - D & C MARINE BOAT BUILDERS,INC; BRISTOL, RHODE ISLAND MIC/DCM WAS DONALD MARINE; ASSETS ACQUIRES BY OCEAN SCOUT MARINE;
DCZ - DISTRICT OF COLUMBIA HOMEMADE BOATS
DDQ - D & D MARINE MFG. CO. HOUSTON, TX
DDX - CONCEPTS BOATS INC.
DED - DOWN EAST DORIES
DEL - DELTA MARINE, INC.
DEM - DELHI MFG. CORP. (DELCRAFT)
DES - DESOTO MFG. & SUPPLY CO.
DEV - DEAVER CUSTOM BOAT
DFF - DUFFY ELECTRIC BOAT CO; CALIFORNIA
DFG - DIVERSIFIED FIBERGLASS PRODUCTS
DFL - DOLPHIN BOATS, INC. PRINCETON, FL
DFM - MOSSBACK BOAT MFG. CO.
DFP - DELCO FIBERGLASS PRODUCTS
DFV - DRIFTER MARINE, INC.
DID - TILTON BOATWORKS INC JENSEN BEACH, FL
DKP - DIAMOND BACK MFG.INC COCOA, FLORIDA
DKQ - COMPASS YACHTS SOUTH ORLEANS, MASSACHUSETTS
DLI - DIVERSITY LAMENATORS, INC.
DLK - DEL-CRAFT ANTIOCH, CA
DLN - DOLPHIN BOATS, INC. MIAMI, FL
DLZ - DELAWARE HOMEMADE BOATS
DMA - EDGEWATER POWER BOATS EDGEWATER, FLORIDA
DMB - DI MARCO BOATS
DMC - DOUGLASS & MCLEOD INC. GRAND RIVER, OH
DMH - HOSEA MFG. CO.
DMN - DOGGETT MARINE INDUSTRIES, INC.
DMP - DAYTON MARINE PRODUCTS
DMR - DONZI MARINE,INC.(NEW CODE BMA/DNA) AS OF 10/93
DNA - DONZI MARINE (PREVIOUSLY BMA/DMR) PARENT COMPANY IS AMERICAN MARINE HOLDINGS BMA/DNA AS OF 10/93 PRIOR TO THAT COMPANY WAS P
DNC - DURANAUTIC MFG. CORP.
DNU - DURANAUTIC, INC.
DNX - DANA CUSTOM BOATS GARDEN GROVE, CA
DOR - C-DORY INC. KENT, WA
DPD - DOLPHIN CANOE CO.
DQU - BOSUN MARINE MARKETING, INC DEL QUAY, USA, LTD.
DRE - DRIFT CRAFT
DRM - DREAMBOAT CO., INC.
DRU - CUTLER GATE PERRINE, FL
DSC - DOLPHIN BOATS LTD. NORTH CHICAGO, IL
DSN - DISCOVERY MARINE PREBLE, NY
DST - DORSETT MARINE, INC.
DTN - BUMBLE BEE BOATS TULLAHOMA, TN
DUC - THE DUCK BOAT COMPANY, INC; NEWCASTLE, MAINE MIC ASSIGNED_1997
DUF - DUFOUR YACHTS USA,INC ANNAPOLIS, MARYLAND; MIC/DOA ORIGINALLY ASSIGNED THEY NEVER USED. CHANGE MADE TO REFLECT NEW MIC/DUF O
DUJ - DUFFY & DUFFY FIBERGLASS BOATS, INC BRIIKLIN, MAINE MERGED WITH FLYE POINT CORP MIC/FPC TO FORM ATLANTIC BOAT COMPANY INC; S
DUR - DURACRAFT BOATS, INC.
DUS - DUSKY MARINE, INC.
DUT - DURATECH MFG. CO.
DUW - DUROBOAT MFG. INC.
DUX - DOUGLAS MARINE CORP. DOUGLAS, MI
DUY - MOTION MARINE CLEARWATER, FL
DVD - DAVIDSON MOTORS
DVN - ASSOCIATED RECREATIONAL PRODUCTS CORP PLAYBOUY BOATS/DAR-VAN MFG
DWD - DARRAH INDUSTRIES INC.
DWE - CHIEF MFG., INC. D & W ENTERPRISES
DXA - DIXIE AIRBOATS, INC.
DXD - DIXIE DEVIL MFG. CO.
DXE - DIXIE BOAT WORKS
DXF - DIXIE FIBERGLASS PRODUCTS
DXM - DIXIE MARINE MFG. (DIXIE CRAFT)
DYB - DYNAMAGLAS BOAT CO.
DYE - DYERCRAFT BOATS THE ANCHORAGE, INC
EAD - EDEY & DUFF INC MATTAPOISETT, MASSACHUSETTS
EAK - KARELSEN CUSTOM BOATS
EBA - EXPLORER BOAT & CANOE CO.
EBK - EBKO INDUSTRIES
EBV - EASTERN BOAT WORKS
ECB - BELL YACHTS DESTIN, FL
ECJ - ESCAPE CRAFT, INC. UNION, NEW JERSEY
ECX - CANE CUTTER, INC. (ED CAIN, INC., & RIGIF PLASTICS, INC.)
EDY - EDDYLINE NORTHWEST KAYAKS OR EDDYLINE NORTHWEST LTD. BURLINGTON WASHINGTON; KAYAKS AND CANOES
EFJ - PAGEPOWERBOAT INC. GALLATIN, TN
EGG - EGG HARBOR BOAT CO.
EGM - EAGLE MFG., INC.
EHT - CANTRELL MARINE LITTLE ROCK, AR
EKH - CAROLINA SKIFF, LLC; WAYCROSS, GA
EKW - MARLIN BOATS, INC. PERFORMER FOBERGLASS PRODUCTS
ELB - ELIMINATOR BOATS
ELD - ELDO CRAFT BOAT CO.
ELE - ELITE BOATS
ELG - ELGIN
ELH - ELCO MARINE SANTA ANA, CA
ELX - ELI LAMINATES CO., INC.
EMD - CARIBE INFLATABLE USA INC MIAMI, FL
EMH - ENTERPRISE MITCHELL CO.
EMO - EAGLE MARINE BOAT MFG., INC.
ENB - ENTERPRISE BOATS, INC.
ENC - ENSIGN SPARS, INC DUNEDIN, FLORIDA PREV ASSIGNED TO ENDEAVOURYACHT
ENN - ENSIGN YACHTS
EPB - ECO PRODUCTS
EPY - HC COMPOSITES, LLC; TARBORO, NORTH CAROLINA WORLD CAT SOLD WCC GROUP TO HC COMPOSITES
ERC - ERCOA INDUSTRIES BRAHAM, MINNESOTA MIC/FRC ALSO ASSIGNED AT SOME POINT PER USCG
ERF - EASY RIDER FIBERGLASS
ERY - ERICSON YACHTS INC.IRVINE, CALIFORNIA
ESF - EXUMA SKIFF MIAMI, FLORIDA
ESK - ESKAY PLASTICS, LTD.
ESM - DUCKWORTH BOAT COMPANY
ESN - RANDALL CRAFT, INC.
ETC - EBBTIDE CORP.
ETF - EAST TEX FIBERGLASS PRODUCTS
ETK - EDWARDS BOATS & TANKSORT PIERCE, FL
ETW - BENNINGTON MARINE CORP% ELKHART, INDIANA
ETY - EAGLE TRAWLER YACHTS / MARINE TRADING INTERNATIONAL PARENT CO MILLER YACHT SALES
EVI - BOULTON POWERBOATS; OREGON
EVN - ENVISION BOATS, INC. MONMOUTH, IL
EWC - ECKLER WATERSPORTS TITUSVILLE, FL
EWV - WALKER BAY BOATS, INC.
EXH - EXCLUSIVE ENTERPRISES
EXT - EXPOERTS INTERNATIONAL SAN FRANCISCO, CA
EXU - ASTRO PLASTICS CORP. (EXCELLO CORP.)
EXV - EXECUTIVE BOATS
EZR - EZY-RYDER CORP. CLANTON, AL
FAA - BRUCE FAER DUNWOODY, GA
FAB - FABUGLASS CO., INC.
FAN - SPARKMAN MARINE SAUGUS, CA
FAR - FARRIER MARINE, INC; BELLEVUE, WASHINGTON
FAV - QUALITY FABRICATORS OF FRANKLIN,INC.
FBB - FORMOSA BOAT BUILDING CO.
FBC - H & H FIBERGLASS, INC.(JIM HENDERSON MFG.)
FBE - CARSTEN INDUSTRIES INC.MELROSE, MN
FBF - FIBER-FORM (DIV. OF BAYLINER MARINE)
FBG - US INDUSTRIES, INC. (FIBERFORM)
FBK - FIBERKING BOAT CO. (FIBERKING, INC.)
FBN - FANTASY BOATS INC. GLASSPORT, PA
FBQ - FLORIDA BAY COASTER CO GREEN COVE SPRINGS, FL
FBT - DIVERSIFIED PRODUCTS FORESTER BOATS, INC.
FBU - FRANKFORT BOAT WORKS,INC FRANKFORT, MAINE PURCHASED ASSETS OF WINTERPORT BOAT CO (WNP)
FCL - FIBER-CELL, INC.
FCN - FALCON BOATS OF CALIFORNIA
FCP - FIBERCRAFT MFG. CO.
FCS - FALCON BOATS, INC.
FDX - FREELAND MANUFACTURING CAPE CORAL, FL
FEA - FEATHERCRAFT
FFG - FRANKLIN FIBERGLASS EUTIS, FL
FFL - F & F BOAT CO.
FGB - FIBERGLASS FABRIC, INC. (CHAPARRAL BOATS, INC.)
FGD - FIBERGLASS UNLIMITED
FGE - COBALT BOATS
FGQ - FOUNTAIN POWERBOATS INC.
FHS - OFFSHORE PERFORMANCE INDUSTRIES,INC.
FIA - F. A. MCCULLOUGH, INC.
FIN - CENTURIAN BOATS
FIW - FIBER SPORT INC. AMORY, MS
FLB - FOLBOT CORP.
FLD - FLYING DUTCHMAN
FLI - FELT INDUSTRIES, INC.
FLQ - FLAGSHIP YACHT SALES, INC.
FLZ - FLORIDA HOMEMADE BOATS
FMC - FISHER MARINE, INC. TOPEKA, IN
FML - FLUID MOTION, LLC; KENT , WASHINGTON MIC/FML PREV ASSIGNED TO FREEDOM MARINE PROD
FMS - BOSTON WHALER MULTIHULL FORMULA RACING SAILBOATS
FMY - FM MARINE
FNQ - FLARE MARINE INC. LAKE WALES, FL
FPK - FORMALL PLASTICS, INC.
FPY - CALIFORNIA SPORT BOATS NEWPORT BEACH, CA
FPZ - FIBERGLASS PLES REC INDUSTRIE BIDDEFIRD, MAINE PURCHASED BY GAZELLE CANOE; SEE MIC/GZL
FQA - DUCK WATER BOATS INC-DOVER, OHIO
FRI - FROST MARINE
FRK - KURTIS KRAFT BOATS
FRU - FOREST RIVER INC MARINE DIV MIDDLEBURY,INDIANA
FRV - FEATHER RIVER BOAT CO. YUBA CITY, CA
FSA - FRANKLIN STORES BRONZE, NEW YORK
FSC - FIBER STEEL CORP.
FSF - FOUR STAR FIBERGLASS CORP. HALLENDALE, FL
FSH - FISH -N- SKI
FSJ - FIBER SKIFF, INCORPORATED
FSM - FISHMASTER
FSO - FIBERGLASS SALES AND PRODUCTS
FTC - FIBERTECH ; CORPUS CHRISTI, TEXAS
FTV - FPC MANUFACTURING MARYVILLE, TN 12/89 NEW OWNER FUTURE BOATS INC
FUR - FURY BOATS (FURY SPEED AND MARINE)
FWM - FAR WEST MARINE SERVICE
FWN - FOUR WINNS (OMC) CADILLAC, MI
FWZ - FIBERGLASS WORKS
FYC - FREEDOM YACHTS% MIDDLETOWN, RHODE ISLAND _ PREV ASSIGNED TO FERRO-YACHT CO; DETROIT, MI
FYS - 2 DAUGHTERS BOATWORKS WESTFORD, VERMONT
GAB - GORE MFG.
GAE - GALAXIE BOATS, INC.
GAG - GAGNIER MFG., INC.
GAK - TIBERIAS MARINE INC DENTON, MARYLAND
GAL - GALAXY BOAT MFG. CO. COLUMBIA, SC
GAT - G-CAT CORPORATION
GAW - AQUA-PADDLE
GAZ - GEORGIA HOMEMADE BOATS
GBC - GREGOR BOATS (GREGOR BOAT CO. & W.W. GREGORY)
GBF - OSAGIAN BOATS, INC.
GBM - GRUMMAN ALLIED INDUSTRIES, INC.(GRUMMAN BOATS)
GBN - GIBSON FIBERGLASS PRODUCTS
GBP - GRUMMAN BOATS INC GRUMAN-CARMICHAELS CORCORAN, CA
GBW - GALAXIE BOAT WORKS, INC.
GCV - GLASTRON-CARLSON
GDB - FLYING SCOT, INC; DEER PARK, MARYLAND
GDV - GO-DEVIL BOATS BATON ROUGE, LA
GDY - GODFREY CONVEYOR CO.
GEB - GOLDEN ERA BOATS NOANK, CT
GEN - GENERAL MARINE INO INC.
GEN1 - GENERATION III, INC.
GGA - GIGI BOAT MANUFACTURERS
GGB - & G BOAT REPAIR & MFG HOLLYWOOD, FL
GGR - MIDLAND CO; COVENTRY, RHODE ISLAND
GHE - GHEENOE GHEEN MANUFACTURING TITUSVILLE, FL
GIG - GIG HARBOR STEEL-CRAFT DANVILLE, IA
GJV - JAVELIN BOAT CO PARENT CO; GENMAR HOLDINGS MURFREESBORO, TN ACQUIRED FEOM OMC BY GENMAR
GLA - GLASTRON BOAT CO.
GLF - GULFSTREAM BOATS, INC.
GLK - GLACIER BAY, INC; MONROE, WASHINGTON PREV GILLIKIN CRAFT
GLS - GLASSPAR
GLX - GREAT LAKE INFLATABLE, INC. (GIL,INC.)
GMA - GENERAL MARINE CO.
GME - GLOBAL MOTORBOAT CORPORATION COLUMBIA, SC
GOF - GREATEST MARINE PRODUCTS OF FLORIDA
GPC - GLASSMASTER BOAT CO., INC. (GLASSMASTER PLASTICS)
GPD - BOATS UNLIMITED CORP. BEACHCOMBER BOATS & GLASS PRODUCTS CO
GPE - GRAND PRIZE BOAT BUILDING, INC.
GPG - GLASSLINE PRODUCTS, INC.
GPL - GLAS-PLY BOATS, INC.
GPP - GAZELLE PRODUCTS CO., INC.
GPW - EZE DRIFT GRANTS PASS, OR
GPZ - GENESIS POWERBOAT CORP SANDUSKY, OH
GQR - SPECIALITY MARINE GROUP, LC; DELEON, FLORIDA
GRB - GREENBOAT SCIENTIFIC, LLC; WELLINGTON, FLORIDA
GRJ - G. R. INTERNATIONAL OF MIAMI MIAMI, FL
GRZ - DESIGN CONCEPTS, CHICO CALIFORNIA OUT OF BUSINESS
GSA - GIBBS SPORTS AMPHIBIANS, INC; AUBURN HILLS, MICHIGAN
GSD - FIBERSTRESS, INC. SURE CAST BOATS,INC.
GSF - GRIFFIS & SONS FIBERGLASS STARKE, FL
GSW - CALIFORNIA BOATS
GSY - GLASSTREAM BOATS
GTP - GLASTEC PRODUCTS, INC; CLEVELAND, OHIO
GTX - GLASTEX CO.
GUF - GULFLINE BOATS
GUM - GULF MASTER
GWC - GULF WIND BOAT CO. GENEVA, AL
GWD - DAVIS, GEORGE W. & SONS, INC.
GXO - BALTIK BOATS ANAHEIM HILLS, CALIFORNIA
GYI - GLOUCESTER YACHTS; GLOUCESTER VIRGINIA
HAB - HAM BOAT WORKS DOWNERS GROVE, IL
HAF - SUNSHINE BOATS
HAL - HALLET
HAN - HANCOCK BOATWORKS
HAO - HARDIN MARINE ANAHEIM, CA
HAT - HATTERAS YACHT DIVISION
HAZ - HAWAII HOMEMADE BOATS
HBC - HERNANDEZ BOAT COMPANY, LLC; HOMESTEAD, FLORIDA _WAS HOBOCO BOATS INC
HBG - HAWAIIAN BOATS, INC.
HBH - HELLS BAY BOATWORKS, INC; TITUSVILLE, FLORIDA
HBU - HOLETON BOAT WORKS
HBW - HOFEMAN BOAT WORKS
HBY - HOWMAR BOATS, INC.
HCB - HOWARD CUSTOM BOATS
HDE - HYDE DRIFT BOATS; IDAHO FALLS, IDAHO MIC/HDE WAS HARDOS ENTERPRISES
HDH - HARLEY BOAT CORP.
HEB - HENRIQUES BOAT WORKS INC; BAYVILLE, NEW JERSEY SOLD TO HENRIQUES YACHTS INC / SAME ADDRESS
HEH - HENRIQUES YACHTS INC; BAYVILLE, NEW JERSEY BOUGHT ASSETS OF HENRIQUES BOAT CO; SEE BMA/HEB
HER - HERTERS, INC.
HEW - HEWES MARINE CO. INC.
HFB - HOLMES FIBERGLASS BOAT CO.
HGG - HIGGINBOTHAN BOAT CO.
HGZ - HYDRO GLASS HAGERSTOWN, MD
HIF - HIFLEY AMERICA SPORTS, INC.
HII - HARRIS INDUSTRIES
HIN - HUSTLER INDUSTRIES HAMPTON BAYS, NY
HIP - SHIPSKILLS, INC.
HKN - HAAKON BOATS, LTD
HKQ - HACKER BOAT CO.INC SILVER BAY, NEW YORK
HKW - HERITAGE KAYAKS
HLK - HERITAGE MARINE, INC.
HLR - MASTER FABRICATORS
HMC - HILINER MARINE CORP.
HMD - HUGH MCGINNIS BOATS
HMJ - HOLIDAY MANUFACTURING
HMS - INTERNATIONAL MARINE; INGLEWOOD, CALIFORNIA BOUGHT HMS MARINE
HMW - HASKELL MARINE SAN FERNANDO, CA
HND - HONDO BOATS MERCED, CA
HNK - HANS KLEPPER CORP.
HNS - HUCKINS YACHT CORP.
HOG - HOOG BOATS, INC.
HOI - SUPERIOR HOVERCRAFT IMPERIAL BEACH,CA
HPL - HY-RYDER INC. TOMAHAWK, WI
HPS - AMERICAN HONDA MOTOR CO.INC. PERSONAL WATERCRAFT/JET SKIS, ETC (PER USCG MIC DATABASE SITE) POWERSPORTS.HONDA.COM/WATERCRAFT
HPY - HAPPY TRAVELER MARINE
HQZ - U.S. COAST GUARD HEADQUARTERS EXCLUSIVE USE OF USCG HDQ OPER DIRECTORATE OFFICE BOATING SAFETY
HSB - HUSTLER BOATS
HSI - HYDRO-STEP CORP.
HSL - HUSTLER BOAT CO. HUSTLER MARINE CO.& HUSTLER, INC.
HSP - HYDRO STREAM BOATS
HST - MASTER ENTERPRISES, INC. HURST ENTERPRISES, INC.
HSX - HYDRA-SPORTS, INC.
HTB - CUSTOM MARINE (HOT BOAT ALLEY & MACHONE BOATS)
HUB - HUBBS YACHT SALES, INC.
HUL - VALCO ALUMINUM BOATS HULLS, INC.
HUN - HUNTER MARINE CORP (PARENT CO-LUHR MARINE GROUP) ALACHUA, FLORIDA
HUP - HUNT PRODUCTS, LTD.
HUR - HURRICANE FIBERGLASS PRODUCTS CO.
HUS - HUSTLER BOAT CO., INC.
HUU - HURST ENTERPRISES, INC.
HUX - HUSTLER MARINE, INC.
HVC - U. S. HOVERCRAFT
HVM - BONAVENTURE IND INC. ROCKLEDGE, FL
HWE - HOLLYWOOD ENTERPRISES, INC.
HXY - HOLBY MARINE BRISTOL, RHODE ISLAND; PREV USED MIC/HKW SINCE LATE 80'S SEE MIC DETAIL SHEET FOR ADDED INFO
HYD - HYDROSWIFT CORP. (DYNA-PAC, INC.)
HZL - HOSTLER CANOE
IAG - AMERICAN EAGLE CANOES COCOA, FLORIDA ACQUIRED ASSETS OF AMERICAN FIBER TECH (AMT)
IAL - ALASKASKIFF ALUMINUM BTWKS%SITKA ALASKA
IAS - IMPACT AUTO SALES RED OAK, TX
IAZ - IOWA HOMEMADE BOATS
IDM - MOMARSH INC; DEFIANCE, MISSOURI
IDZ - IDAHO HOMEMADE BOATS
IGN - SIGNATURE GROUP,INC. THE SIGNATURE GROUP
ILZ - ILLINOIS HOMEMADE BOATS
IMW - IMAR GROUP, LLC; FARGO, NORTH DAKOTA
INO - INNOVATIVE SPORTS HUDSONVILLE, MI
INZ - INDIANA HOMEMADE BOATS
IRI - KEANNEAU AMERICA, INC; ANNAPOLIS, MARYLAND
ITC - INTERCOASTAL S E INC. ANNAPOLIS,MD
JAB - ALLMAND BOATS (JOHN ALLMAND BOATS,INC.)
JAJ - JASON FIBERGLASS
JAY - ORTIZ BOAT MFG. WESTMINSTER, CA
JBC - ALUMA-WELD (JETT BOAT COMPANY)
JBE - JAY BEE BOATS
JBL - JACKSON BOAT SHOP
JBN - JET BOAT ENGINEERING PERFORMANCE ENGINEERING
JBX - JET BOAT ENGINEERING OF OKLAHOMA
JCE - ASTROGLASS BOATS MAIDEN CRAFT & PRO CRAFT
JCL - J.R. CUSTOM MARINE, INC.
JCM - CALIFORNIA YACHTS/CARVER TUSTIN, CA
JCY - WATERWERKS BOAT CO.
JDB - JOHN DORY BOAT WORKS, INC.
JDJ - CONTENDER BOATS, INC. (J.D.MARINE)
JEA - JET BOATS INC. TACOMA, WA
JEB - JET-STER BOATS ROCHESTER, WA (WEBB & CO.)
JET - GLEN-COE BOAT MFG.
JFG - JEFFERSONS FIBERGLASS
JGN - ANDROS BOAT WORKS INC SARASOTA, FLORIDA
JHR - INDIAN RIVER BOATS
JIB - JIM-BAR CO. INC. MANCHESTER, FL
JIS - HOT SPORTS USA INC NEWPORT BEACH, CA
JJJ - FOXCRAFT BOATS, INC. CARBON HILL,AL
JJK - JOEL JENKINS DECATUR, GA
JNB - J.B. BOAT CO., INC.
JNC - JEM-CRAFT
JOK - K L INDUSTRIES%MUSKEGON, MICHIGAN; KL ACQUIRED ASSETS OF K L (MIC/HII) ASSEMBLES BOATS FOR JOHNSON OUTDOORS PUTS MIC/JOK ON 
JRH - HMC MFG. CO. PORT STAR BOAT CO.
JRS - JRS FIBERGLASS UNLIMITED, INC. KONA BOATS, INC
JRY - J.R. YACHT SALES
JSB - JET-STER BOAT CO.
JSC - AQUA IMAGES INC.
JTA - JET-STER BOATS OF ALABAMA
JTB - JET-STER BOAT OF MEMPHIS
JTC - CROWNLINE BOATS INC.
JVS - JOLE VECCHI SCIOMACHEN
KAB - CALIBER 1 BOATS ANAHEIM, CA
KAJ - KAJUN INDUSTRIES, INC.
KAN - THE ROOS BROTHERS
KAW - KAWASAKI MOTORS MFG LINCOLN, NB
KAX - KAY PARK RECREATION CORP.JANESVILLE, IA
KAY - HARRIS-KAYOT, INC. KAYOT, INC.MARINE DIVISION
KAZ - KANSAS HOMEMADE BOATS
KBM - KINDSVATER BOATS FRESNO, CA
KBT - INVADER
KBW - KENNEDY BOAT CO. LOBO BOAT WORKS & KENNEDY BOAT WORKS
KCK - K-CRAFT, INC.
KCM - KENCRAFT MFG., INC; WILSON, NORTH CAROLINA
KDO - CAROLINA FIBERGLASS INC; W COLUMBIA, SOUTH CAROLINA _PURCHASED BY LEADER BOAT CO; MIC/LDR
KEI - KEVCON CORP; FORT DODGE, IOWA
KEL - A C MARINE; FALL RIVER, MASSACHUSETTS
KEN - KENNER MFG. CO. INC KNOXVILLE, AR
KFB - COASTAL MARINE
KFD - AGGRESSOR BOATS, INC. COOCHEE CRAFT K & F BOAT CO
KFL - COMANCHEE BOATS
KGR - KING ENTERPRISES
KHQ - S AND S BOAT BUILDER; FORT PIERCE, FLORIDA
KKC - GHOST INDUSTRIES INC. ISLAND PARK, NY
KKF - KUSTOM KRAFT PERFORMANCE BOATS
KLA - KLASSIC BOAT COMPANY CLEBOURNE, TX
KLI - KIEL INC. GOSHEN, IN
KLO - CLIMATE BOAT CO.,INC.
KME - TRI-STATE CUSTOM FBGLS INC. BAILEY,NC
KMF - CUSTOM BOAT WORKS INC BAILEY, NORTH CAROLINA SE MIC SHEET FOR ADDED DETAILS
KMP - K-MAC & COMPANY ADDISON, TX
KNC - DON'S MARINE
KNG - MASTER MOLDERS, INC. KINGFISHER FIBERGLASS
KNT - KNUTSON BOATS INC GLENVILLE, MINNESOTA
KOO - SPORTCO OF MINDEN INC. MINDEN, LA
KPB - K ENTERPRISES
KRA - KRAMSCO MFG., INC.
KRC - KUSTOM ENTERPRISES, INC.
KRG - IMAGE BOAT CO. KRONENBERG INDUSTRIES, INC
KRU - CRUISERS, INC.
KST - CHARLOMA FIBERGLASS, INCORPORATED CHERRYVALE, KS
KTT - KITCO, INC; WARRENSBURG, MISSOURI SOLD MOLDS TO C.C.FIBERGLASS(CCF) WHO WILL PRODUCE SIMILAR BOATS UNDER DIFFERENT TRADEMARK
KUR - JEFFREY JAY KURTH; ACKLEY, IOWA WWW.CANYAK.COM AND NEW COMPANYNAME J K INC
KVA - KENOVA INDUSTRIES
KVH - KV HYDROS WINTER SPRINGS, FL
KWE - KEY WEST BOATS INC. RIDGEVILLE, SC
KYP - KEY PEN MANUFACTURING; LAKEBAY, WASHINGTON
KYZ - KENTUCKY HOMEMADE BOATS
LAE - BAJA BOAT CO. SIERRA BOAT CORP
LAR - LARSON BOAT CO.
LAY - LAGUNA YACHTS, INC.
LAZ - LOUISIANA HOMEMADE BOATS
LBC - LIVINGSTON BOAT CO., INC.
LBD - LANDAU BOAT CO.
LBL - LUCRAFT BOATS-LABRAY
LBO - LANDAU BOAT COMPANY
LBV - CIMMARRON MARINE
LCB - LYN-CRAFT BOAT CO.
LCN - MAINE MARINE CO. LINCOLN CANOE CO
LCR - RADISSON CANOES GEORGE ROSS ASSOCIATION
LCX - SMALL CRAFT, INC.
LEJ - LEE BOATS
LEL - CAJUN SPECIAL BOATS LOLELL IND
LES - LEISURE IMPORTS, INC.
LFP - LAKE-FLITE PLASTICS KNOXVILLE, TN
LGK - LEGEND CRAFT INC, ARKANSAS
LGX - LOGAN BOATS INC; OCOEE, FLORIDA
LHR - LUHRS ST. AUGUSTINE, FL
LII - LASER INDUSTRIES INC.
LIW - SUGAR SAND MARINE; FARGO NORTH DAKOTA
LKS - LANDING SCHOOL OF BOAT BUILDING KENNEBUNKPORT, MAINE
LLT - LEISURE LIFE LTD GRAND RAPIDS, MI
LMA - CADDO BOAT MFG. CO., INC.
LMK - LOREQUIN MARINE, INC.
LML - LION MAR BOAT CORP. MIAMI, FL
LMM - L & M MFG. CO.
LNC - LAND -N- CRAFT
LNM - LENHAN INDUSTRIES
LNS - LONE STAR FIBERGLASS CO.
LNU - QUICKSTEP, INC WARREN, RHODE ISLAND
LOP - GENMAR LOGIC, LLC / GENMAR HOLDINGS INC; DURHAM, NC SOLD TO GENMAR ASKED FOR NEW MIC/TRB
LPB - MAKO SHARK BOATS LYNCH PERFORMANCE BOATS
LPE - LIFETIME PRODUCTS; UATH
LPM - LEISURE PRODUCTS MARKETING SYSTEM
LPP - FLORIDA MARINE PROPULSION FT. LAUDERDALE, FLORIDA
LPR - LAMINATED PRODUCTS CO.
LSE - LAKELAND SPORTS CENTER; GLENBEULAH, WISCONSIN
LSW - LEE S. WILBUR & CO SOUTHWEST HARBOR, MAINE
LSX - LOCK STOCK & BARREL ELKHART, IN
LTB - ULTRA BOATS, INC.
LTF - LITTLE AND UPTON, INC.
LTT - LOTT-CRAFT BOATS
LUA - BLUE FIN YACHTS; WARWICK, RHODE ISLAND ASSETS SOLD TO SAKKONNET BASSBOAT CO MIC/GHV
LUG - LUGER INDUSTRIES, INC.
LUN - LUND AMERICAN, INC.
LUX - COUGAR MARINE, INC.
LWN - CARL A. LOWE INDUSTRIES, INC. LOWE INDUSTRIES
LYG - SEA FOX BOAT COMPANY, INC /SOUTH CAROLINA
LYN - LYN CRAFT BOAT CO.
LZE - LASER BOATS; ONTARIO, CANADA (PARENT COMPANY-ESSEX PERFORMANCE BOATS)
MAC - MACGREGOR YACHT CORP.
MAD - MAD RIVER CANOE CO., INC.
MAG - MAGNUM MARINE
MAK - MONARK BOAT CO.
MAU - CREST PONTOONS (OWOSSO, MI)
MAX - MAXUM
MAZ - MACS AIRBOATS AND SKIFFS
MB2 - MALIBU BOATS
MBC - MASTERCRAFT BOAT CO.
MBD - MARLIN BOAT CO.
MBE - MANTRA BOAT CO.
MBG - MAGUS BOAT CO.
MBJ - MIZE BOATS
MBK - MAKAI BOATS, INC.
MBP - MITCHELL BOAT CO. DIV OF WILSON PRODUCTS
MBV - MASTERCRAFTERS INC WINNSBORO, LA
MBY - MYACHT, INC; SPRINGFIELD, MISSOURI PURCHASED BY TRACKER MARINEMIC/BUJ
MBZ - MB SPORTS; ATWATER, CALIFORNIA MBZ WAS MONTEREY BOATS, INC SANTA CRUZ, CA
MC2 - MARINE CITY
MCC - MICH-CRAFT CORP.
MCD - MCDANIEL BOAT CO., INC.
MCH - UNICRAFT BOATS BRADENTON, FL
MCO - MOLLY'S COVE BOAT WORK; MATTAPOISETT, MASSACJUSETTS
MCP - MAINE CAT; BREMEN, MAINE TREV ASSIGNED TO MASTER CRAFT PLASTICS
MCS - MAYBURY'S CANOE SHOP
MCX - RIVER JAMMER CANOE CO. BRENTWOOD, NH
MCZ - MICHIGAN HOMEMADE BOATS
MDT - MIDDLE TENNESSEE FIBERGLASS, INC.
MDZ - MARYLAND HOMEMADE BOATS
MEB - MELGES BOAT WORKS, INC; ZENDA, WISCONSIN ALSO IMPORTING FROM SOCA; SEE MIC/XHO
MEN - MENGER BOATWORKS, INC; AMITYVILLE, NEW YORK _ASSETS ACQUIRED BY THOMPSON BOATWORKS; MIC/TBV
MEY - MEYERS INDUSTRIES, INC.
MEZ - MAINE HOMEMADE BOATS
MFG - MOLDED FIBER GLASS BOAT
MFJ - MYERS FIBERGLASS FABRI
MFL - MOBILE FIBERGALSS SERVICES NAVARRE, FL
MFN - MARBEN MARINE
MFP - MIDWESTERN FIBERGALSS PRODUCTS
MFS - MIKE F. SHANNON CO.WITCHCRAFT & APACHE
MFS1 - GLASSLINE, INC.
MGE - MAGIC BOATS INC.
MGI - MARINE GROUP INC. ASTRO/PROCRAFT MURFREESBORO,TN BMA/MGI LINCOLN,AL BMA/MGI(A) ALSO WAHOO BRAND LINCOLN, AL BMA/MGI(A) ALSO 
MGK - MIKE GAULT CANOES
MGM - MAGTEX CO. MAGNUM BOAT
MGW - MONTGOMERY WARD CO.
MGZ - MIRAGE BOAT CO., INC.
MHA - MILFORD HAVEN MARINE
MHP - MEL-HART PRODUCTS, INC.
MHV - MARINERS HAVEN, INC.
MIB - MILLER BOATS ROCKPORT, TEXAS
MIJ - MIRAGE MARINE CORP.
MIS - MIDWEST SEAT MFG. CO., INC.
MISC - MISCELLANOUS BMA CODE
MIX - MARITIME MARINE, LLC; AUGUSTA, MAINE
MIZ - MISSISSIPPI HOMEMADE BOATS
MJC - M AND J BOAT CO.
MJI - DYNASTY BOATS
MJK - MAJEK BOAT WORKS
MKC - MCKEE CRAFT
MKE - MIKE BUTLER MARINE DESIGN
MKH - METZELER KAUTSCHUK
MKS - MAKO, INC.
MLB - MALLE BOAT WORKS,INC STUART, FLORIDA WAS MILLE BOATWORKS, MN
MMB - MUIR MAID BOATS
MMC - MARSHALL MARINE CORP; SOUTH DARTMOUTH MASSACHUSETTS
MML - MELEN MARINE, LTD.
MMM - MERRIMACK MARINE, INC.
MMN - MOHAWK MFG. CO.
MMP - MONTGOMERY MARINE PRODUCTS
MMS - MUNCIE METAL SPINNING, INC.
MMY - MIDDLE BAY BOATS
MNB - MANNING ENTERPRISES
MNJ - BORUM BOATS, INC.
MNL - MANNIX PLASTICS; BOATS
MNN - MANATE MARINE
MNT - MANATEE MARINE PRODUCTS, INC.
MNX - MANNINO BOATS
MNZ - MINNESOTA HOMEMADE BOATS
MOD - MODUM EXECUTIVE SERVICES, INC.
MOH - MUHLEN INDUSTRIES CINCINNATI, OH
MOK - MOON BOATS
MOM - WESMOR COMPANY INVERNESS, FL
MOS - MORRIS BOAT SHOP
MOU - VENTURA WHOLESALE, INC.
MOV - MAN-O-WAR PERFORMANCE
MOZ - MISSOURI HOMEMADE BOATS
MPB - CORSA MARINE LTD. OPA LOCKA, FL
MPC - MAINSHIP CORP/ PARENT COMPANY SILVERTON YACHT; ST AUGUSTINE FLBEGAN USING MIC/MPT IN 1996 WITHOUT PERMISSION
MPD - BRUNSWICK MARINE POWER TOPEKA, KS
MPH - MARSHLAND MARINE, INC.
MPM - COMBEE AIRBOATS, INC.
MPW - MERCURY MARINE DIVISION OF BRUNSWICK CORP MIRAMAR, FLORIDA
MQW - MAELSTROM MARINE INC. SARASOTA, FL
MRB - MARQUIS BOAT CO., INC.
MRCM - MERCURY MARINE INFLATABLES MERCURY MARINE/QUICLSILVER
MRE - MOORE ENTERPRISES
MRG - MIRAGE MARINE, INC. PALMETTO, FL
MRH - MARIAH BOATS
MRJ - MARQUIS BOATS, INC.
MRK - MAKO MARINE, INC.
MROB - MERCURY OUTBOARD (DIVISION OF BRUNSWICK CORP)
MRR - MIRRO MARINE DIV. MIRROCRAFT & MIRRO MARINE
MRX - MARINER MARINE, LTD.
MRY - CATALINA YACHTS/MORGAN DIV LARGO, FL
MSC - MANSET MARINE SUPPLY ROCKLAND, ME
MSZ - MASSACHUSETTS HOMEMADE BOATS
MTC - MITSUI MIAMI, FL
MTM - MARK TWAIN MARINE INDUSTRIES WEST FRANKFORT, IL
MTW - TEAM WARD INC MONTICELLO, AR MIC/PREV ASSIGNED TO MOUNTAIN MOUNTAIN LAKES MARINE
MTZ - MONTANA HOMEMADE BOATS
MUN - WILLIAM E MUNSON COMPANY BURLINGTON, WASHINGTON WAS MUNRO BOAT BUILDERS KEY WEST, FL
MVH - OLSON CO. CUSTOM YACHTS
MVI - ATLANTIS FIBERGLASS
MVR - MORAVIA INDUSTRIES
MWE - BOBCAT BOATS GLOSTER, LA
MWK - INVADER BOATS, INC. MANUFACTURER'S WHOLESALERS INC
MXB - BEACHCAT BOATS INC OLDSMAR, FLORIDA
MXJ - MIDNIGHT EXPRESS, INC.
MXK - MAXUM MARINE; ARLINGTON, WASHINGTON PREV MARK MARINE; NH
MXU - MONZA MARINE
MYD - TARVA CUSTOM BOATS CLOVIS, CA
MYW - AMERICAN FIBERLITE, INCORPORATED
NAB - NORTH AMERICAN BOAT CORP.
NAD - NADEN INDUSTRIES
NAP - EXCALIBUR MARINE CORP LIGHTING BOATS
NAS - NORTH AMERICAN SLEEKCRAFT INC LAKE HAVSU CITY, NEVADA OUT OF BUSINESS 2/1/10
NBA - NORTON BOAT WORKS
NBC - NATIONAL BOAT CORP.
NBO - MARATHON BOAT CO.INC
NBP - NIMBLE BOAT INC; CLEARWATER, FLORIDA
NBS - NORMAN'S BOAT SHOP
NBV - ONION RIVER BOATWORKS FRANKLIN, NEW HAMPSHIRE
NBZ - NEBRASKA HOMEMADE BOATS
NCZ - NORTH CAROLINA HOMEMADE BOATS
NDC - NORDIC BOATS
NDZ - NORTH DAKOTA HOMEMADE BOATS
NEC - VERMONT CANOE & KAYAK; WAITSFIELD, VERMONT SOLD MULTIPLE TIMES
NEG - NEODESHA PLASTICS, INC.
NEH - NORTH END COMPOSITES ROCKLAND, MAINE PURCH BY SABRE (HWS) 1994
NER - NORIEASTER YACHTS
NEW - NEWMAN INDUSTRIES, INC.
NFK - NORTHEAST FIBERGLASS; WALDOBORO, MAINE
NFZ - NOLES FIBERGLASS BOATS WINTERHAVEN, FL
NHZ - NEW HAMPSHIRE HOMEMADE BOATS
NIS - NISSAN MARINE & POWER PRODUCTS CARROLLTON, TX
NJZ - NEW JERSEY HOMEMADE BOATS
NKH - NICKELS & HOLMAN CO FENTON, MICHIGAN
NMC - INTREPID MFG. CO., INC.
NMF - FIBERGLASS BUILDERS, INC.
NMR - NITRO MARINE
NMS - NORTHSIDE MERCURY MARINE NORTHSIDE MERECURY SALES ROYAL AMERICAN NORTHSIDE
NMZ - NEW MEXICO HOMEMADE BOATS
NNA - NONA BOAT CO.
NOR - CRESTLINER INC. LITTLE FALLS, MN
NPC - JANCO PLASTICS
NPR - DAN WERTZ
NPT - INFINITY POWER BOATS COLUMBIA, SOUTH CAROLINA MIC PREV LOCKLEY NEWPORT BOATS,CURRENTLY ON SITE OF GLOBAL MOTORBOAT MIC/GME
NRB - NORTH RIVER JET BOATS INC; ROSEBURG, OREGON SHUT DOWN BY FBI DUE TO FRAUDULENT ACTIVITIES, ASSETS OWNED BY WELLS FARGO
NTL - GRADY-WHITE BOATS, INC. NATIONAL BOAT WORKS,INC
NUM - NUZUMS MARINE LOS ALAMITOS, CA
NVY - NAVIGATOR YACHTS, INC. PERRIS, CA
NVZ - NEVADA HOMEMADE BOATS
NWD - NORTHWEST WATERCRAFT SALEM, OR
NWN - NEWTON BOATS INC. SLIDELL, LA
NYZ - NEW YORK HOMEMADE BOATS
OBI - O'BRIEN INTL INC REDMOND, WA
OBR - OBAR MARINE, INC.
OCB - OCEANIC BOATS
ODR - DREAM BOATS INC HUDSON, FLORIDA
OEY - LORD NELSON YACHTS, SEATTLE, WASHINGTON
OFF - OFFSHORE INDUSTRIES
OFS - OFFSOUNDING
OHZ - OHIO HOMEMADE BOATS
OKZ - OKLAHOMA HOMEMADE BOATS
OMB - OMNIBOAT INTERNATIONAL MT. PLEASANT, SC
OML - OMC FISHING BOAT GROUP INC PARENT CO-OUTBOARD MARINE CORP MURFREESBORO, TN ACQUIRED STRATOS AND JAVELIN BOAT MIC NOT CHANGED
OMM - STARLINE BOATS, INC.
OPL - OUTERLIMITS OFFSHORE POWERBOATS; RHODE ISLAND
ORC - ORCA MARINE & FIBERGLASSING, INC.
ORZ - OREGON HOMEMADE BOATS
OSB - OFFSHORE BOAT CORP.(FORMER NAME) NEW NAME-WHITEWATER BOAT CORP MIAMI, FL
OSD - OSPREY BOAT COMPANY; SILVANA WASHINGTON ASSETS ACQUIRED BY CMSENTERPRISES (CMS)
OTC - OTTER CRAFT, INC.
OYI - OFF SHORE YACHTS INTERNATIONAL
PAB - PADDLE KING, INC CARSON CITY, MICHIGAN PREV ASSIGNED TO PABST BOATS WISCONSIN
PAC - PACEMAKER CORP.
PAP - PANTHER AIRBOATS CORP.
PAX - INDUSTRIAL PLASTIC SYSTEMS
PAZ - PENNSYLVANIA HOMEMADE BOATS
PCG - PACIFIC NORTHWEST DESIGNS INC BELLINGHAM, WA
PCH - AMERCIAN HOVERCRAFT & SPORT ANAHEIM, CA
PCJ - PLACE CRAFT BY HAMILTON, INC; SOUTH EL MONTE, CALIFORNIA
PCM - PLEASURE CRAFT MARINE ENGINEERINGCO.
PCW - PRECISION BOAT WORKS
PCX - PEARSON COMPOSITES, LLC WARREN, RHODE ISLAND SEE MIC DETAILS
PDC - P & D BOAT CORP.
PDI - PRO DESIGN, INC; WAUKESHA, WISCONSIN MIC/PDI PREV ASSIGN TO PILOT DINGHYS WHOSE ASSETS ACQUIRED BY STAR WING MIC/WIJ
PDL - PRINDLE CATAMARANS (SURFGLAS, INC.)
PEA - PEARSON YACHTS; MADISON, WISCONSIN
PER - PERFORMER BOAT CO.
PEV - SEA-RAIDER BOATS, INC.
PFD - PITTSBURG FIBERGLASS INC. PITTSBURG, IL
PFS - PERFORMANCE SAILCRAFT
PGI - PROGRESSION INDUSTRIES
PGR - PROGRESSIVE MFG. CO.
PGS - PEGASUS PRODUCTS
PHB - PHANTOM BOAT, INC.
PHU - PHANTOM BROTHERS, INC. PHANTOM BOAT INC
PHV - PACIFIC HOVERCRAFT
PHX - PHOENIX PRODUCTS, INC.
PIO - SEA-PRO BOATS, INC. CHAPIN, SC
PIR - PIRANHA MARINE
PKA - PAYNE'S BOAT WORKS MILTON, FL
PKD - NOVOURNIA OF NORTH AMERICA PROKO INTERNATIONAL IND
PKM - PETERSON MFG. CO.
PLC - PRO-LINE BOAT CO.
PLD - POLLARD ENTERPRISES, INC.
PLE - POLARIS INDUSTRIES LP
PLF - PLAY-CRAFT PONTOON CO.
PLI - TRULINE, INC; PUYALLUP, WASHINGTON
PLR - POLAR KRAFT MFG. CO.
PME - PRECISION MARINE
PMR - PANTHER MARINE CORP.
PMY - PREMIER MARINE INC WYOMING. MINNESOTA
PNS - PENSACOLA BOAT MFG. CO.
PNT - PIONEER BOATS
PNY - PFC, INC.
POV - PRO ADVANTAGE SALT LAKE CITY, UT
PPB - PETES PLASTIC BOAT WORKS BLUE HILL, ME
PPD - PORTLAND PUDGY,INC PORTLAND, MAINE PREV PACK & PADDLE
PPE - PERFORMANCE PLUS PRODUCTS
PPJ - PARAMOUNT POWERBOATS
PPN - POWERQUEST BOATS, INC% MICHIGAN
PPY - PINCH-A-PENNY
PQC - HYDROTECH SYSTEMS INC MEDFORD, OR
PRD - PREDATOR MARINE; E DETROIT, MICHIGAN MIC/PRD WAS PARD BOAT MFGTX ASSETS OF PREDATOR ACQUIRRED BY VICIOUS POWER BOATS MIC/VPB
PRG - FIN AND FEATHER MFG. CO.
PRN - PROUT USA BALTIMORE, MD
PRO - PRO CRAFT, INC.
PRX - PORTER MFG., INC.
PSD - PEARSON UNLIMITED ELKHORNY, CA
PSL - J BOATS WEST PERFORMANCE & LASER SAILCRAFT
PSW - AVS LAMINATES BELLPORT, NEW YORK
PTJ - AMERICAN RADHIAL PARA-TECHINTERNATIONAL
PTR - POINTER CORP; YARMOUTH, MAINE
PVT - PRIVATEER MFG. CO.INC
PVX - PORTSMOUTH BOAT CO.INC WOLFEBORO, NEW HAMPSHIRE
PWB - EXCLUSIVE POWER BOAT HIALEA GARDENS, FL
PWL - POWELL LEAD CO. WALLACE, NC
PWN - POWER MARINE INC. FT. LAUDERDALE,FL
PWR - POWER CAT MFG., INC.
PWS - PACIFIC WATER SPORTS SEATTLE, WA
PWV - PARKS MFG,INC (DBA) BLUE WAVE BOATS SEMINOLE, OKLAHOMA
PXM - PARKER MARINE ENTERPRISE INC.(BEAUFORT, NC)
PYB - PENN YAN BOATS, INC.
PYH - PYTHON BOATS
PZV - PRAIRIE VIEW INDUSTRIES, INC; FIABURY, NEBRASKA
QBS - JET CRAFT BOATS / DIV OF WESTWINN GROUP CORP
QCM - CAMANO MARINE LTD-DELTA,BRITISH COLUMBIA CANADA BRACEWELL MARINE GRP BC ACQUIRED CAMANO MOLDS FROM CAMANO MARINE LTD SOLD TH
QDQ - QUESSY CANOES, INC% CANADA
QEQ - DORAL BOATS-OWEN SOUND, ONTARIO CANADA
QFI - FABRITEK INC; LEMIEUX, QUEBEC CANADA
QGT - GRAYSTAR INDUSTRIES, LTD; OWEN SOUND, ONTARIO CANADA
QHN - COMPLAST INC-HAM NORD QUEBEC CANADA
QJA - DORAL INTERNATIONAL,INC GRAND MERE, QUEBEC CANADA PREV USED MIC/ZDB PER CANADIAN COAST GUARD
QJE - FUTURE BEACH CORP; POINTE CLAIRE, QUEBEC CANADA
QJT - PRINCECRAFT BOATS, INC PRINCEVILLE, QUEBEC CANADA SOLD TO BRUNSWICK CORP SEE MIC/ZZA
QKN - SEAWARD KAYAKS; CHEMAINUS, CANADA
QKR - KROPF INDUSTRIAL, INC PARRY SOUND ONTARIO CANADA
QLS - SUPERCRAFT BOAT MFG. PORT ALBERNI,BC
QLU - LUNENBURG COUNTY SHIRWRIGHTS PETITE RIVERE, NOVA SCOTIA CANADA
QMJ - STANLEY MACHINE 799200 ONT; PARRY SOUND, CANADA
QNK - NECKY KAYAKS LTD. ABBOTSFORD, BC
QNT - NITERAN FIBERGLASS INC HAM NORD QUEBEC CANADA; FORMERLY NITERAM FIBERGLASS INC
QPA - SOUTHLAND; ST JOSEPH OF BEAUCE, QUEBEC CANADA ALLIED WITH INTERNAUTIC MARINE GRP; MIC/YBN
QPQ - PDQ YACHTS, INC; WHITBY, ONTARIO CANADA
QRK - BRIG INFLATABLE BOATS CONCORD,ONTARIO CANADA
QRS - RELIANCE SAILING CRAFT CO MONTREAL, CANADA
QSR - MERCURY MARINE FOND DU LAC, WI QUICKSILVER INFLATABLES
QYG - SAGA MARINE; ST CATHERINES, ONTARIO CANADA _SOME BOATS BUILT FOR SAGA USING MIC/PCS-PACIFIC SEACRAFT
QZT - ZEPPELIN TECHNOLOGIES INC. FT. LAUDERDALE, FL
RA1 - AMF ROBALO DIVISION
RAL - AMF ROBALO AMF CRESTLINER & AMF POWERBOAT
RAN - RANGER CANOE CO. ASHLAND, NH
RAS - RAYSON MARINE RAYSONCRAFT
RBD - RAY BOND BOATS
RBM - RENKEN BOAT MFG. CO.
RBO - R B BOATS; BEAVER CREEK, OREGON
RCB - ROGERS CUSTOM BOATS
RCD - RIVIERA CRUISER; COLUMBIA CITY, INDIANA
RCH - RICH LINE BOATS RICHLAND MFG. CO.
RCT - RABCO COMPETITION MARINE
RCY - ROSE CRAFT MFR. CO.
RDA - CHARGER BOAT COMPANY
RDD - REDDING BOAT WORKS CENTRAL VALLEY, CALIFORNIA
RDJ - SEBRICH CRAFT, INC.
RDL - ELLIS BOAT CO.INC SOUTHWEST HARBOR, MAINE
RDW - AZURE BOAT COMPANY, INC; WILMINGTON, CALIFORNIA
REG - REGATTA BOATS
REN - REINELL BOATS, INC.
REP - REINFORCED PLAST CO; GOULDSBORO, MAINE
RFD - RENEGADE FIBERGLASS IN
RFG - REED FIBERGLASS
RFO - SEA CORE-INWOODS VENTURA, CA
RFR - AMERICAN BOAT BUILDING REEF ROAMER MARINE
RGA - R.B.RODGERS YACHT SALES; NOANK, CONNECTICUT IMPORTS BOATS FROMFINLAND
RGF - SEABRING MARINE IND DBA-MONTEREY BOATS
RGH - ROUGHNECK BOAT CO.
RGI - SEA RANGER MARINE, INC.
RGL - HEWES BOAT CO. REGAL FIBERGLASS,INC
RGM - REGAL MARINE INDUSTRIES, INC.
RGN - ROAD BASIN FIBERGLASS
RGP - RIVERS-GILMAN MOULD PRODS.
RHE - ROCHELL CRAFT CORP.
RHT - SURF-JET CORP.
RHY - RHYAN-CRAFT BOATS MFG.
RID - RAM INDUSTRIES; ELKHART, INDIANA KAYAKS & PADDLEBOATS
RIF - ADDICTOR BOATS REEF, LTD.
RIG - OUTRIGGER BOAT CORP; CHICAG, ILLINOIS
RIV - RIVERVIEW MARINE INC PORT RITCHIE, FL
RIZ - RHODE ISLAND HOMEMADE BOATS
RJA - RADIANT MARINE CORP. SARASOTA, FL
RJD - R.J. DOUGHERTY ASSOC INC; FLORIDA
RJS - OLYMPIAN BOATS R.J. SMITH CO.
RKA - RK INDUSTRIES, INC STRASBURG, VIRGINIA
RKL - RKL BOATWORKS; MT DESERT, MAINE
RKO - RIVER LAKES MANUFACTURING LITTLE ROCK, AR
RLS - CHARLESTON FIBERGLASS CO.
RLT - REVENGE ADVANCE COMPOSITES; SAINT PETERSBURG, FLORIDA _PREV R L YACHTS
RLY - ROYAL CRAFT BOAT CO.
RNF - REYNOLD FIBERCO, INC.
RNG - RANGER BOATS; WOOD MANUFACTURING CO.INC FORREST WOOD MFG. ARKANSAS
RNK - RINKER BOAT CO., INC.
RPG - RAMPAGE YACHTS PARENT COMPANY KCS INTERNATIONAL,INC ACQUIRED BY CRUISTAR INC 3/93 CHANGE NAME TO KCS INTERNATIONAL INC. 2009
RQA - RIVER QUEEN BOATS EUTAW, AL
RQE - HYDROCRAFT INC SCOTTSDALE, AZ
RRB - ROGUE RIVER BOAT SHOP
RRH - OBT HAMMOND & ASSOCIATES AUSTIN, TX
RRR - REBEL INDUSTRIES INC JACKSON, MICHIGAN
RRS - GOLDENHAWK PRODUCTS RECREATION RESEARCH
RSB - RSB FIBERGLASS FORMS
RSD - BERNARD ROLSMA & CO. TOPSFIELD, MA
RSE - CHARGER CUSTOM BOATS RUSSELL MFG
RSO - STUART MARINE CORP; ROCKLAND, MAINE
RTN - BEAR CREEK CANOE INC LIMERICK, ME
RTR - ROBERTS MARINE
RUF - RUF-MAID BOAT WORKS MARATHON, FL
RVF - RIVERSIDE ASSOCIATES FRANCETOWN,NH
RVG - RIVERCRAFT MARINE PANAMA CITY, FL
RVJ - RIVERMASTER, INC LIVE OAK, FL
RVK - RIVER RUNNER KAYAKS
RVP - RIVA YACHTS OF FORIDA, INC.
RVR - RIVERA BOAT, INC.
RXN - REACTION MARINE MIAMI, FL
RXO - RYAN CRAFT CAPE CORAL, FL
RYY - SUNRAY PRODUCTS OLDSMAR, FL
RZD - R & D INVESTMENTS
RZJ - RAVEN BOATWORKS INC.
RZT - T.& S. BOATS, INC WHITE BLUFF, TN
SAB - SHEW & BURNHAM S BRISTOL, ME
SAG - SAN AUGUSTINE FIBERGLASS PRODUCTS
SAJ - S & J MANUFACTURING INC WILLACOOCHEE, GEORGIA S & J BUILDS AQUATRON & BASSTREAM LINES PREV SABINE BOAT BUILDERS OOB-1980
SAL - TIDERUNNER INC. TACOMA, WA
SAN - SANGER BOAT MFG.
SAV - SEA ARROW MARINE CORP.
SAW - SAWYER CANOE CO.
SAZ - SHASTA ALUMINUM PRODUCTS
SB2 - SUNBIRD BOAT CO., INC.
SBC - SUMMER BOAT CO.
SBI - SPARTAN BOATS, INC.
SBM - SOONER BOAT MFG. CO.
SBQ - AMERICAN POWER BOATS SEAHAWK BOAT CORP/I.M.A. MANUFACTURE UNLIMITED
SBT - OZARK FIBERGLASS PRODUCTS
SBW - STAUTER BOAT WORKS
SBY - SUPERBOATS, INC. AMITYVILLE, NY
SCC - SCAT-CRAFT MARINE, INC.
SCF - SAIL CRAFT OF CANADA ILE PERROT,PQ CANADA
SCN - SEACREST MARINE CORP.
SCN1 - SCORPION MARINE INC.
SCO - HAWAIIAN RESOURCES, INC.
SCP - STARBUCK CUSTOM BOATS-PRODUCTS
SCR - SPORT CRAFT, INC. PERRY, FL
SCS - STOWE CANOE STOWE, VT
SCT - SCOTT BOAT CO., INC.ANKORCRAFT
SCW - SCHWILL YACHTS ODESSA, ONTARIO CANADA
SCX - SPRING CREEK PRAMS; TONASKET, WASHINGTON _MIC PREV ASSIGNED TO-SCOTT PLASTIC 72-84
SCZ - SOUTH CAROLINA HOMEMADE BOATS
SDA - SCHIADA BOATS
SDB - STUR-DEE BOAT CO.
SDD - SEDA PRODUCTS
SDJ - SAILING DAKOTA, INC BMA/MIC FORMERLY ASSIGNED TO SABREJETS OUT OF BUSINESS 1/1981)
SDZ - SOUTH DAKOTA HOMEMADE BOATS
SEA - SEA NYMPH MFG. STANRAY CORP
SEC - SEA CRAFT, INC.
SEE - SUNRISE ENTERPRISE WEST JORDAN, UT
SEI - S.E.I. CORPORATION
SEJ - SEAJAY BOATS, INC.
SEK - SEA KING
SEN - SEABIRD INDUSTRIES, INC.
SER - SEA RAY BOATS, INC.
SES - SEARS AND ROEBUCK, MARINE DIV.
SEV - SEVYLOR USA, INC. SEVYLOR OF NORTH AMERICA
SEZ - DYNAFLITE MFG. CO., INC. SERENDIPITY, INC
SFI - SIKES FIBERGLASS PRODUCTS COBBTOWN, GA
SFQ - FIESTA BOATS
SFR - SEAFARER FIBERGLASS YACHT HUNTINGTON, NEW YORK
SFS - SURFSIDE HOUSEBOATS IN
SGA - SUNSET BOAT CO., INC. SILVERTON,OR
SGH - SISU BOAT INC; PORTSMOUTH, NEW HAMPSHIRE ASSETS ACQUIRED BY NORTH SHORE BOAT WORKS MIC/NHS
SGN - SIGNA CORP. THUNDERBIRD PRODS
SGP - SOUTHEASTERN GASS LAMENATORS, INC.
SGZ - SHAMAR GLASS
SHA - SHAMROCK MARINE DIVISION
SHU - SHERWOOD INDUSTRIES, INC.
SIC - TRACKER SEACRAFT OF FL.TAMPA, FL
SIJ - QUEST AQUA PROD INC. SPOKANE, WA
SIN - MUFF'S BOATWORKS PONCHATOULA, LA
SIR - SARASOTA CATBOAT CO; OSPREY, FLORIDA
SIT - SHARK INDUSTRIES, INC.
SIZ - SEA CREST INC.
SJC - SEBRING BOATS DIV. OF C & S ENTERPRISES
SJN - SUNKISST JET BOATS MFG.CORDOVA, TN
SJR - STAR BOAT CO.
SKB - DILKS & CO.
SKG - SHOCKWAVE CUSTOM BOATS CORONA, CALIFORNIA SKG WAS SKAGEN BOATS
SKJ - SKI BOATS, INC.
SKM - SKIMMAR BOATS
SLB - SHELL LAKE BOATS DIV. OF LUND AMERICAN
SLC - SAILCRAFTER YACHT KITS COSTA MESA CA
SLE - SLEEK CRAFT BOATS
SLK - AMF SLICKCRAFT AMF POWERBOAT & AMF ROBALO
SLP - SCOUT BOATS INC. SUMMERVILLE, SC
SLS - SAILNETICS, INC.
SLV - SILVERLINE, INC. MOOREHEAD PLASTICS, INC
SMD - SEA MAID
SMK - SMOKER LUMBER CO., INC.
SMT - SACRAMENTO BOAT MFG.
SNA - SNARK PRODUCTS, INC.
SNF - SING FISHER, INC.
SNT - COLLINS CRAFT, INC. SANTA ROSE BOAT-CAMPERS
SNX - SUNDANCE MARINE
SOE - MARITEC INDUSTIRES, INC.
SOM - SEAARK BOATS; MONTICELLO, AR (SOM) USCG ASSIGNED CODE
SOP - SCORPION POWER BOATS
SP3 - SUNSATION PERFORMANCE BOATS; ALGONAC,MI
SPA - SPACE CRAFT BOATS WORKS, INC.
SPE - SPECTRA MARINE
SPR - SUPERIOR PLASTICS, INC. MARLIN BOATS
SPT - SPORTSTER MFG. CO.
SPU - SPORTSMAN CANOE CO.
SPX - SPORTSPAL, INC.
SQN - SOUTHERN OFFSHORE YACHTS; TARPON SPRINGS, FLORIDA
SRC - STEURY CORP.
SRF - STARFIRE INDUSTRIES
SRK - HELM INDUSTRIES
SRN - SCARIANO BOATS INC. NEW ORLEANS,LA
SRS - WEERES INDUSTRIES
SRW - SAVAGE RIVER WORK SWANTON, MD
SSB - SEA SPRITE BOAT CO.INC.
SSM - SOUTHERN STAR MFG.INC.
SSR - SEA STAR BOAT CO.
SST - SOMERSET BOAT CO. SUMERSET MARINE
SSU - S2 YACHTS, INC.
SSY - CONNEC-A-DOCK; ADAIR, IOWA MIC PREV ASSIGNED TO SHERMAN _SHIPYARDS INC (OOB-771220)
STA - STAMAS YACHT INC. TARPON SPRINGS,FL
STE - SKEETER PRODS.INC. STEMCO MARINE
STF - STERNCRAFT BOAT CO.
STM - SAF-T-MATE, INC. FOUR WINNS
STN - SILVERTON MARINE CORP.
STR - STARCRAFT MARINE STARCRAFT CO
STY - STYRON'S LLC PREVIOUSLY DBA STYRON'S BOAT WORKS AND STYLECRAFT BOATS INC%CREOLE LA
SUE - SUPERIOR PLASTICS
SUN - SMOKER-CRAFT NEW PARIS, IN
SUR - SURFGLAS, INC. (PRINDLE CAT)
SUT - SUTPHEN MARINE CORP.
SUZI - SUZUKI INTERNATIONAL
SVM - SOVEREL MARINR INC; N PALM BEACH, FLORIDA
SVU - STINGER BOAT CO.
SWE - THE STOWE CANOE CO. (MANSFIELD CANOE)
SWL - SEA SWIRL
SWM - SIDEWINDER OF WISCONSIN (SIDEWINDER MARINE, INC.)
SWN - STILL WATER DESIGN; CHELSEA, MASSACHUSETTS MIC PREV ASSIGNED TO SUWANNE CRAFT
SWT - SWITZER CRAFT, INC PREV SWITZER CRAFT INC ASSIGNED TO SWITZER PRODUCTS CORP FROM 10/72 TO 4/97
SWX - MAC INDUSTRIES
SXE - SOUTH DADE BOAT REPAIR & MFG.
SXJ - SEA VEE CORP.
SXL - NORTH AMERICAN CATAMARANS SOLD CATAMARANS & TOM ROLAND SAILBOATS
SXO - SPEEDO BOAT INC. MIAMI, FL
SXS - SEA HUNT BOAT MFG.CO,INC; LEXINGTON, SOUTH CAROLINA
SXV - SIGNATURE MARINE CO.
SXY - MINI DINGHY BOAT COMPANY; PARENT CO-SAILBOAT SHOP INC; TEMPE, ARIZONA
SYB - SCHUCKER & ASSOCIATES CAPE CORAL,FL
SYK - R & R FIBERGLASS CO. STRYKER BOATS
SYL - SYLVAN INDUSTRIES, INC.
SYX - STARBOARD YACHT CO. STUART, FL
SZA - SHOAL RUNNER BOATS ROLLA, MO
SZG - SPINDRIFT YACHT NEWPORT, CA
SZX - SHALLOW SPORT BOATS PORT ISABEL,TX
TAA - TADD MANUFACTURING CORP POPLAR BLUFF, MO
TAD - VALLEY FABRICATING, INC; BLACKFOOT, IDAHO NAME CHANGE FROM RAPID CRAFT, INC
TAE - TIBURON YACHTS; BOULDER, COLORADO
TAH - BELL INDUSTRIES TAHITI BOATS
TAJ - JACKSON CORP.
TAN - TANZER INDUSTRIES LTD; DORION, QUEBEC CANADA
TAR - FAIRPORT YACHTS, INC PARENT CO-TRISTAN INTERNATIONAL FAIRPORT HARBOR, OHIO
TAY - TAYLOR BOATS
TAZ - PEMBERTON AIRBOATS INC INVERNESS, FL
TBA - TEELS BOAT WORKS
TBB - TOM-BOY BOAT CO.
TBH - THE BLUE HOLE CANOE CO.
TBI - THOMASTON BOAT WORKS, INC.
TCB - T-CRAFT BOAT CO.INC
TCM - FAIRPORT YACHTS, LTD; FAIRPORT HARBOR, OHIO
TCT - THUNDER CRAFT BOAT, INC.
TCZ - TREMBLAY CUSTOM BOATS CHIEFLAND, FL
TDA - LAZER
TDC - TIDE CRAFT, INC.
TDL - TRADITIONAL WATERCRAFT; LARGO, FLORIDA
TDP - STEYR-DAIMLER-PUCH OF AMERICA CORP.
TDS - TRIDENT MARINE SALES, LTD.
TDY - SEMPREIT-LEISURE AMER PORT EVERGLADES, FL
TEJ - SHADOW, INC. (TEAM MAJIC)
TER - TERRY BASS BOAT
TFA - ABLE SHIPWRIGHTS INC E HAMPTON, CONNECTICUT
TGF - TWO GUYS FABRICATION CENTRAL POINT,OR BEGUN IN 1978 CHANGED NAME IN 1980 TO: FISH-RITE BOATS SAME USCG MIC CODE KEPT
TGO - TIDE RIVER USA INC TAMPA, FL
THB - THUNDER HAWK BOATS NASHVILLE, GA
THC - THE HINCKLEY COMPANY; TRENTON, MAINE PREV ASSIGNED TO THRILLCOMFC CO; MICHIGAN
THD - THUNDERBIRD RACING TECHNOLOGY PORTLAND, OR
THE - BOATHOUSE, THE
THM - TROPHY SPORTSFISHING BOATS LAKE FOREST, IL (PARENT COMPANY TRITON BOAT CO, LP;BMA/TJZ)
TIG - SPORTBOATS INC. JUSTICE, IL
TII - TRITON INDUSTRIES INC LANSING, MI
TIK - TIKI INTERNATIONL
TIX - TIGE BOATS, INC% ABILENE, TX
TKB - SUNSET BOAT CO.
TKF - THE CANOE OUTFITTERS BIRCHWOOD, WI
TLE - GLASSMATE MFG. CO. INC.
TLY - TOLLYCRAFT CORP.
TMC - TAFT MARINE, INC.
TMD - TROLLER BOAT CORP BUTLER, PA
TMH - TOMAHAWK, INC.
TML - TRADEWINDS MARINE, INC.
TMO - TALON MARINE CO SARASOTA, FL
TMR - TOM SAWYER BOATS
TMS - THOMPSON BROS. BOAT MFG.
TMU - FRIDAY HARBOR YACHT SALES, FRIDAY HARBOR, WASHINGTON
TN1 - THUNDERBIRD PRODUCTS CORP.NORTH MIAMI, FL
TNA - TANA CORP.
TNE - TANZER YACHTS INC; EDENTON, NORTH CAROLINA
TNR - THUNDERBIRD PRODUCTS CORP. DECATUR, GA
TNV - TENNESSEE VALLEY FIBERGLASS CO.
TNY - TANZER YACHTS; ARLINGTON, WASHINGTON
TNZ - TENNESSEE HOMEMADE BOATS
TOR - THOMAS MARINE CHECOTAH, OK
TOU - CAJUN PERSUASION BOAT BLDRS LAFITTE, LA
TOY - TOYO-TIRE AND RUBBER CO., LTD.
TPC - TRIPLE C ENTERPRISES
TPI - TEAM WARLOCK INC. CORONA, CA
TPL - TPL BOATS
TPP - T AND P PLASTICS, INC.
TRA - TRAILORBOATS CO INC SONOMA, CA
TRB - TRIUMPH BOATS; PARENT CO-GENMAR IND, INC; DURHAM, NC MIC/TRB WAS TURBOCRAFT OF PALM EACH
TRC - TARPON RIVER BOAT SHOP; BOCA RATON, FLORIDA MIC/TRC WAS TRI WAS TRI CAT MARINE
TRH - HARRY TURNER; ATKINSON, NORTH CAROLINA
TRI - THREE R INDUSTRIES ALMONT, MI
TRJ - TROJAN YACHT DIV.
TRP - F L TRIPP & SONS; WESTPORT POINT, MASSACHUSETTS
TRR - NACR (NORTH AMERICAN CATAMARANS & TOM ROLAND SAILBOATS)
TRS - TRI-SONIC MARINE DIV.
TRT - THE SKANDIA CO. GREEN COVE SP, FL
TRV - TRAVELLER BOATS STANRY
TRX - TELWATER (USA) LLC; MONCKS CORNER, SOUTH CAROLINA
TSA - EXPLORER YACHT, INC. SOUTH COAST BOAT CO
TSB - CHAMPION BOATS THE STORIE CO
TSP - TILLOTSON-PEARSON-HENRY, INC. TPI COMPOSITES, INC WARREN, RI
TSW - SILLINGER AMERICA IRVINE, CA
TTP - BOBBY JONES AIRBOATS DAVENPORT, FL
TTS - TIM'S TRAILER SAILS AND BOATS
TTS2 - CREEK CRAFT MFG. INC.
TUF - GLASWAY INC.
TUR - VIZ INDUSTRIES
TXN - CHAN SIEW TIN CO; SAN FRANCISCO, CALIFORNIA
TXZ - TEXAS HOMEMADE BOATS
TYA - FLYING DUTCHMAN, LTD.
TYC - TALMAN YACHT CO; WARREN, RHODE ISLAND
TYR - TAYLOR BOATS HI-PERFORMANCE MARINE
TYS - TYLER DIESEL POWER SYSTEMS
TZM - TREASURE MARINE
UBF - BFC MARINE INC-SPRINGFIELD, LOUISIANA MAKES GATOR TRAX BOATS
UBM - UBM MANUFACTURING
UDC - UDISCO, INC.
UFQ - GATOR TAIL, LLC; LOREAUVILLE, LOUISIANA
UMC - UNIVERSAL MARINE SERVICE
UME - UNITED MARINE CORP OF TENN; MARYVILLE, TENNESSEE ACQUIRED ASSETS OF INBOARD MARINE CORP MIC/IMT
UNF - MURRAY CHRIS CRAFT BELLINGHAM, WA
USA - QUICK SILVER INFLATABLES MFG BY MERCURY MARINE
USH - MAXUM MARINE
USJ - BAYLINER MARINE CORPORATION
UTZ - UTAH HOMEMADE BOATS
UWH - FLUID MARINE, LLC; AUBURN, WASHINGTON ACQUIRED ASSETS OF C-DORY MARINE, INC; MIC/CDO
VAB - VALCO ALUMINUM BOATS VALLEY ALUMINUM BOATS
VAG - VAGABOND SAILBOATS, INC.
VAM - VAMPIRE BOAT CORP.
VAZ - VIRGINIA HOMEMADE BOATS
VBC - VIKING BOAT COMPANY
VCL - CARAVELL BOATS INC. AMERICUS, GA
VIC - VICAN, INC.
VKB - VIKING BOATS STAMTON, CA
VKP - VIKING BOATS STAMTON, CA
VKX - VIKING BOATS GROTON, CT
VLS - SEMINOLE BOAT CO. VALDOSTA, GA
VLT - VOLUNTEER CORP.
VMG - VANDERSTADT & MCGRUEP, LTD; OWEN SOUND, ONTARIO CANADA
VMK - MOKAI MANUFACTURING INC; NEWBURGH, NEW YORK PREV IN BEACON NY
VMP - DESIGN MARINE CORP; SANFORD, FLORIDA PURCHASED INITIAL MARINE
VNB - VENTURA BOATS, INC.
VNG - VANGUARD, INC.
VOY - LAKE RAIDER CAMDENTON, MO
VRH - RHINO ROTO MOLDING; MAPLE LAKE, MINNESOTA MFG DUCK BOATS SOLD BY BRAND NAME OTTER OUTDOORS
VSF - SHAMEL BOAT & CANOE WORKS; GRAND LAKE STREAM, MAINE
VSM - VANSANT MARINE
VTZ - VERMONT HOMEMADE BOATS
VVN - VIVIAN INDUSTRIES PLASTICS
VVV - CHRYSLER BOAT CORP.
VXP - VIP MARINE INDUSTRIES
VXX - MARIAH BOATS, INC. MAGNUM MARINE,INC.
VYN - RIA YACHTS VICTORIA YACHTS, INC
WAC - WACO MFG., INC.
WAG - TIM WAGNER SARASOTA, FL
WAJ - WATERCRAFT AMERICA, INC.
WAT - WATERCAR; FOUNTAIN VALLEY, CA
WAZ - WATER VENTURES IRVINE, CA
WB2 - WESTWIND BOATS, INC.
WBB - WEBBCRAFT, INC.
WBC - WHITE BOAT COMPANY BALDWINVILLE, MA
WBD - WILLARD BOAT WORKS
WCH - EQUINOX BOATS LOUISVILLE, TN
WCW - PANTERA MARINE INC.
WDB - WELDBILT ALEXANDER, AR
WDC - WARRENCRAFT DISTRIBUTOR, INC.
WDN - WOODSON
WDS - W.D. SCHOCK W.D. SCHOCK MARINE FIBERGLASS
WDT - WREIDT CUSTOM BOATS
WEB - WESTBAY BOAT & MFG CO SEQUIN, WA
WEL - WELLCRAFT MARINE
WEM - PERCEPTION, INC.MARBA GLAS & WILLIAM MASTERS
WEN - WENZEL FIBERGLASS BOATS
WES - DAVE WESTPHAL BOATS WESTPHAL BOATS
WET - WEST MARINE
WFE - CUSTOM WELD BOATS; LEWISTON, IDAHO
WFF - WILSON FIBERGLASS INC THEODOSIA, MO
WFP - WARRIOR BOATS
WFX - WORLD'S FINEST PRODUCT
WGN - MARIAN BOAT WORKS ANCHORAGE, AK
WHB - WHITE WATER BOATS
WHO - WAHOO BOATS UNLIMITED
WHT - WHITE HOUSE
WII - WINDSPEED INTERNATIONAL, INC.
WIJ - STARWING NEWPORT, RI
WIL - WILLIE'S R AND D
WIN - WATER BUSTER INC.
WJI - WAVE INDUSTRY INC DICKSON, TN
WJW - ULTRANAUTICS CORP OXNARD, CA
WKG - WELDCRAFT MFG. INC.BENTON, AR
WKM - WALKIKI MARINE
WKY - WILDERNESS SYSTEMS HIGH POINT, NC
WLB - WELDON BOATS
WLG - WOOLDRIDGE BOATS; SEATTLE WASHINGTON WOOLRIDGEBOATS.COM
WLR - WOLVERINE MARINE CO.
WLT - WILGATE
WLZ - WHITELINE MARINE CENTER BLOUNTSTOWN, FL
WMB - NEWMAN COMPANY
WMP - WEST MARINE PRODUCTS
WMQ - WAITSBORO MFG. CO. INC CORBIN, KY
WMR - WHITEWATER MARINE REPAIR%BOISE ID
WNB - WINNER BOATS
WNO - VISION BOATS, INC.OLD HICKORY, TENNESSEE
WNP - WINTERPORT BOAT CO.WINTERPORT, ME
WNR - HARBOUR, INC.
WNZ - WASHINGTON STATE HOMEMADE BOATS
WOL - WOLFER BOATS
WPC - WILDERNESS PRODUCTS CO., INC.
WPP - WINNEBAGO POWER PRODUCTS OSHKOSH, WI
WPQ - WALDEN PADDLERS INC. CONCORD, MA
WQU - WEST COAST ULTRA BOATS, INC. SAN FERNANDO CALIF.
WRA - ADVANCED MARBLE SYSTEM COCOA, FL
WRN - WARREN CRAFT HURRICANE & WARREN CUSTOM BOATS
WRS - WEERES INDUSTRIES ST. CLOUD, MN
WSE - WEINS SALEST ENGINEER WSE MARINE
WSF - WINDSURFING INTERNATIONAL, INC.
WSH - WEST SHORE BOAT CO. HOPE, RI
WSP - WAVE SPORTS, INC. STEAMBOAT SPRINGS,CO
WST - PISCES BOAT CO.WEST WIND BOAT CO
WSW - KOZLOFF ENTERPRISES SALES SPORTS,LTD
WSZ - WISCONSIN HOMEMADE BOATS
WTE - SCANDY WHITE BOATS, INC BLOUNTSTOWN, FL
WTU - WESTERN ALUMINUM PRODS FRESNO, CA
WTX - HEYDAY%BRUNSWICK FAMILY BOAT CO INC KNOXVILLE TN
WVZ - WEST VIRGINIA HOMEMADE BOATS
WXH - FALCON BOATS, INC. WI HUDSON CO.INC
WYK - INFLATABLE BOAT CENTER WIKING INFLATABLES
WYM - WATKINS YACHT AND MARINE
WYR - SEAWORTHY YACHTS, INC.
WYZ - WYOMING HOMEMADE BOATS
WZR - BRYANT INTERPRISES INC MARYVILLE, TN
XAA - BAHAMA INDUSTRIES INC SANCARLOS, CA
XAG - ARGOSY TOURS SERVICE
XAM - SEMINOLE BOAT CO. WILLACOOCHEE, GA
XAN - ALLEN MARINE MFG INC POMONA, CA
XAX - AZIMUT YACHTS; FLORIDA, ITALY MULTIPLE ADDRESSES WORLDWIDE
XBD - AMERICAN INTERNATIONAL AIRBOAT, INC.
XBQ - MAAS BOAT CO. RICHMOND, CA
XBW - OZARK BOAT WORKS
XCA - ICON BOAT WORKS, INC.
XCI - CARIBBEAN YACHTS INC FT. LAUDERDALE, FL
XCM - MICHAEL CREECH BRADENTON, FL
XCS - CARRERA POWERBOAT CO.
XDC - ZODIAC OF NORTH AMERICA BOUGHT AVON RUBBER 1998 SUMMERVILLE,SC
XDK - DEVLIN BOATBUILDING OLYMPIA, WASHINGTON
XDY - BANGOR PUNTA MARINE O DAY CORP.
XEC - OME, INC.
XEE - INTEX RECREATION CORP; LONG BEACH, CALIFORNIA FORMERLY ZEE TOYS
XEP - CLACKACRAFT RIVER BOATS CLACKAMUS, OR
XET - SOUTHEASTERN PLASTIC TOOLING
XEZ - YACHTEZ.COM INC. FORT LAUDERDALE, FLORIDA
XFE - INTEGRITY MARINE CORP.
XFR - SEIDELMANN YACHTS
XHC - BRITISH SPORTS HOVERCRAFT, LTD. SUNRIDER HOVERCRAFT
XJN - SAN JUAN EAST, INC; ATLANTIC BEACH, NORTH CAROLINA
XKA - OCEAN KAYAK FERNDALE, WA
XKB - SUPRA SPORTS, INC.
XKX - SEAWAY BOATS, INC.
XLD - EXCEL MARINE
XLM - OLYMPIC BOAT COMPANY GUNNISON, UT
XLR - SINBAD THE SAILOR
XLY - ISLANDER YACHTS, INC.
XMA - OMAHA FIBERGALSS CO.
XMG - TRICORP BOATS, INC. OMEGA BOAT CORP
XMO - ACTION MARINE DISTRIBUTORS SUFFERN, NEW YORK
XMP - IMP BOATS APECO CORP
XMR - OUCHITA MRNE & IND CORP ARKADELPHIA, AR
XNA - NORTH AMERICAN FIBERGLASS
XNP - INTERPUBLIC INDUSTRIES MONTREAL CANADA
XOE - ADVENTURE BOATS, INC. COBB, CA
XPK - STOTT CRAFT
XRA - ABLE MARINE CO; MARBLEHEAD, MASSACHUSETTS ASSEST ACQUIRED BY MORRIS YACHTS MIC/TMY
XRR - ORRION BOATS ORRION MFG., INC
XSA - COASTAL MARINE PRODUCT
XSB - OSBORN BOAT-MARINE, INC.
XSF - SABRE MARINE, INC.
XSK - SUNSEEKER USA, INC; FLORIDA
XSW - SKI BOATS, INC.
XTB - SUPREME INDUSTRIES, INC.
XTC - OLD TOWN CANOE CO. OLD TOWN, ME
XTD - THREE OCEANS MARINE CORP; ANNAPOLIS, MD
XTG - SPEED SPECIALTIES MARINE
XTL - STERLING MARINE, INC.
XUE - SUN RUNNER MARINE
XUO - MARINE US INC; POMPANO BEACH, FLORIDA
XUP - CUSTOM FIBERGLASS PRODUCTS; PORT RICHEY, FLORIDA
XUS - SINTERPLAST
XUY - OUYANG BOAT WORKS LTD WHITBY ONTARIO CANADA OUT OF BUSINESS
XVA - INVADER CORP.
XVG - SOVEREIGN YACHT CO.INC LARGO, FLORIDA
XVQ - NAVIMO USA, INC; SARASOTA, FLORIDA PARENT CO-PLASTIMO INTL
XWC - OLD WHARF DORY CO. WELLFLEET, MA
XWI - TRADEWIND INFLATABLES, INC COSTA MESA, CALIFORNIA
XWZ - WATER SKEETER SPORTS STOCKTON, CALIFORNIA INFLATABLE PONTOON BOATS
XXI - AQUASTAR INFLATABLES ORANGE, CALIFORNIA OUT OF BUSINESS
XXN - SEA-N SPORT BOAT CO; BRADENTON, FLORIDA LINKED TO MIC/MCH & DLI
XYB - BALTIC YACHTS EAST WILTON, CONNECTICUT
XYM - IRWIN YACHT AND MARINE
XYN - SWEDE 55 YACHTS OF NA; BEVERLY HILLS, CALIF
XYV - COMMODORE YACHT CORP.
XYX - OCEAN YACHTS CO.
XYZ - AQUARIUS PERFORMACE YACHTS; ANNAPOLIS, MD SAILING YACHTS CHANGED MIC TO XYA TO AGREE WITH MIC ISSUED IN DENMARK
XZH - YSH, LLC-LEWES, DELAWARE IMPORTING INFLATABLES FROM HOLLAND
YAM - YAMAHA MOTOR CO. LTD.
YAR - YAR-CRAFT, INC.
YAT - YATES MANUFACTURING CO.
YDV - BOMBARDIER CANADA; WAUSAU, WISCONSIN; MODEL YEAR PRIOR TO 2002MIC/BMA/ZZN (BOMBARDIER CORPORATION)
YFX - SHARPE CANOES, LTD; MANN'S MOUNTAIN, NEW BRNSWICK CANADA
YHN - Y & H PRODUCTS COASTA MESSA, CA
YOC - YONTECH MARINE USA INC. DANIA, FL
YSI - SEMINOLE MARINE HAVANA, FL
YUK - YUKON INFLATABLES USA SOQUEL, CA
ZAG - ALUMINUM GOODS PAREN CO-PRODUCTS NAUT, ALCAN; PRINCEVILLE QUEBEC CANADA
ZAS - AQUA SPORT OF CANADA, LTD.
ZBI - CAMPION MARINE CORPORATI0N% BRITISH COLUMBIA CANADA
ZBL - ABBOTT BOATS LTD; ONTARIO CANADA
ZBY - BAYFIELD BOAT YARD LTD CLINTON ONTARIO, CANADA
ZCB - ALCAN PRODUCTS, LTD.
ZCW - SCHWILL YACHTS, INC ODESSA, ONTARIO CANADA
ZDB - DORAL BOATS LTD GRAND MERE, QUEBEC CANADA; HAVE DIV IN TN DOROLA BOATS USA
ZED - WEDCO INDUSTRIES
ZEF - D. B. R. SPORTS INC. GRANDES-PILES, PQ
ZEP - PELICAN INTERNATIONAL QUEBEC,CANADA
ZEX - EXE FIBRECRAFT, LTD.
ZFR - FIBRE DE VERRE RAWDON ENGRNG RAWDON, QUEBEC CANADA
ZFS - LES VOILIERS PERFORMANCE, INC.
ZHA - HARBOR MFG. LTD.
ZHW - LES BATEAUX PETERBORGH
ZHY - 891884 ONTARIO LIMITED ST CATHERINES, ONTARIO CANADA
ZIE - INDUSTRIES ESPADON, INC PRINCEVILLE, QUEBEC CANADA
ZJT - JJ TAYLOR & SONS; LEASIDE, ONTARIO CANADA
ZJX - GRAND BANKS DORY WORKS SQUAMISH,BC
ZKA - KAWARTHA CANOE CO. LIFTLOCK FIBERGLASS PRODUCTS
ZKC - CENTURY CRAFT MARINE PRODUCTS; WINNIPEG, MANITOBA CANADA
ZLJ - FRONTIERSMAN FIBERGLASS PRODUCTS
ZLL - LARIVEE MARINE ENGINEERING; POCASETT, MASSACHUSETTS
ZLT - LUCAT MARINE LTD (SHELTER COVE/3 R'S MARINA)
ZMB - MUNRO BOATS; LONDON, ONTARIO CCANADA
ZMC - MOISE CADORETTE INC GRAND MERE, QUEBEC CANADA
ZMR - MISTY RIVER MARINE, LTD
ZMU - BATEAUX ST-MAURICE BOATS INC SHAWINIGAN, QUEBEC CANADA
ZNA - NORTH AMERICAN FIBERGLASS LONDON, ONTARIO
ZNW - NORWEST CANOES LESAG, QUEBEC CANADA
ZPT - PASSAROLA TRADING
ZPW - MOUNT PLEASANT COMM WORKSHOP VANCOUVER, CANADA CANOE & KAYAKS
ZRL - ROSBOROUGH BOATS, LTD; HALIFAX, NOVA SCOTIA CANADA
ZTQ - TEMABEX; ROUYH, QUEBEC CANADA
ZTY - ONTARIO YACHTS CO, LTD BURLINGTON, ONTARIO CANADA
ZUY - OUYANG BOAT WORKS, LTD; WHITBY, ONTARIO CANADA IMPORTER R.BLANTON, ALOHA YACHTS N. AMERICA
ZWC - WEGU CO CANADA, INC; WHITBY , ONTARIO CANADA
ZWO - WOODSTREAM CORP.
ZXM - CADOR-MAT ST JEAN D-PILES, QUEBEC CANADA
ZYR - YORK RIVER INDUSTRIES LTD.
ZZA - ALTRA MARINE PRODUCTS PRINCECRAFT; PRINCEVILLE QUEBEC
ZZG - SUZUKI MARINE; JETS SKIS ETC
ZZI - BANKES HUNTING BOATS; PORT ROWEN,ONTARIO CANADA
ZZM - MOONEY ENTERPRISES LTD. SURREY, RC
ZZN - BOMBARDIER CORPORATION WAUSAU, WI AFTER MODEL YEAR 2002; 2002 BEARS THE MIC BMA/YDV BOMBARDIER CANADA ALSO SEE; BMA/YDV-BOMB
ZZW - WALKER BOAT BUILDING LTD, CANADA
