~<BLANK>
0FT - 144 TACTICAL, LLC BRANDON, MS
VSC - 2 VETS ARMS COMPANY, LLC STIGLER, OKLAHOMA
TW0 - 2A ARMAMENT, LLC BOISE, IDAHO
CCT - 2A HOLDINGS, INC. (CONSTITUTION ARMS) MAPLEWOOD, NEW JERSEY
AZN - 2A ZONE ALTA LOMA, CALIFORNIA
THB - 300 ARMS INC. WELLINGTON, CO
TGL - 3G TACTICAL, LLC TIPP CITY, OHIO
SSM - 3RD GEN MACHINE, INC. (SHARPS BROS MFG) LOGAN, UTAH
FTC - 5 TOES CUSTOM, LLC CARROLLTON, TEXAS
FVA - 5150 ADVANCED SYSTEMS AKA 5150 ARMORY ORANGE, CA
GYS - 556 GUYS (HARDESTY, JEFFREY L.) NACOGHOCHES, TX
FFG - 556 GUYS (HARDESTY, JL) NACOGDOCHES, TEXAS
FFS - 556 TACTICAL SHREVEPORT, LA
ULC - 74U LLC RICHWOOD, TX
EYP - 80 PERCENT ARMS SANTA ANA, CA.
ETD - 802TRADERS, LLC (SIREARMS) LYNDONVILLE, VT
A0P - A O PRECISION MANUFACTURING-DAYTONA BEACH, FLORIDA
AHT - A S H INDUSTRIES INC. DBA A S H TACTICAL FREDERICKSBURG, VA
AWS - A W C SYSTEMS TECHNOLOGY
A0M - A&O MOLD & ENG. INC. VICKSBURG, MICHIGAN
ASQ - A-SQUARE COMPANY; BEDFORD, KENTUCKY
AUN - A-TAC GEAR GUNS UNIFORMS,LLC (A-TAC ARMS) AURORA,CO
ABD - A. B. DISTRIBUTORS
FAG - A. FAGNUSMFR. OF REVOLVERS & PISTOLS
G0A - A. GILONMFR. OF VELO-DOG REVOLVERS
F0X - A. H. FOX (STERLINGWORTH)DOUBLE-BARREL SHOTGUNS
AUB - A. J. AUBREYMFD. FOR SEARS
AJD - A. JOSEPH DEFOURNY
KUS - A. KRAUSSER NOT IVER JOHNSON
ARS - A. R. SALES CO.MFR. OF .45 PISTOL FRAMES
STR - A. STROEGER-DO NOT CONFUSE WITH STOEGER ARMS
SCH - A. W. SCHWARZLOSE
A0S - A06 ARMS, LLC ALMA, COLORADO
AAC - AA ARMS CORP.MODEL HILL, NC
AZA - AA MODELO 1916MODEL OF ARRIZABALAGA & AZANZA
AAQ - AA TACTICAL (ANDREW RENCICH) CRESTVIEW, FLORIDA
ALD - AAA/AAA MODEL 1919 TRADEMARK OF ALDAZABAL
ARL - AARCO OR ARNOLD ARMS COMPANY (MADE APOLLO BOLT ACTIONS & RIFLES) ALSO MADE RIFLES & ACTIONS BY OTHER MANUFACTURERS; REMINGTO
ABE - ABADIE
ABF - ABC RIFLE COMPANY LAS VEGAS, NEVADA
ABC - ABERCROMBIE & FITCH (A & F)IMPORTER ONLY
ABM - ABESSER & MEREL
SSS - ABILINE MARSHAL MFG BY J. P. SAUER & SONS
EE - ABSENTEE-SHAWNEE TRIBES OF INDIANS OF OKLAHOMA USE COUNTRY CODE IF MAKE CAN NOT BE DETERMINED
ACU - ACCU-MATCH INTERNATIONAL MESA AZ
ACC - ACCU-TEK ; CHINO CALIFORNIA-OUT OF BUSINESS IN 1999 RECORDS NOW AT ATF TRACE CENTER-OUT OF BUSINESS DEPT.SEPARATE MFG LIC FR
AIL - ACCURACY INTERNATIONAL LIMITEDHAMPSHIRE, ENGLAND; MFR. OF RIFLES.
AXI - ACCURACY X, INC. AKA AXI HARDY, VIRGINIA
CUR - ACCURATE ARMS LIVERMORE, CA
ALZ - ACCURATE ORDNANCE, LLC WINDER, GEORGIA
A0L - ACCURATE TOOL & MFG CO., INC -LEXINGTON, KENTUCKY
ACH - ACHA/ACHA HERMANOS
ACI - ACIER COMPRIME / ACIER SUPERIEUR
ACK - ACKLEY, P. O.MFR. OF RIFLES. IMPORTER
MTK - ACMC 93,LLC (MOS-TEK) MESA,AZ
ST - ACME ARMS CO.SUBSIDIARY OF STEVENS
DVT - ACME BRAND OF DAVENPORT
ACL - ACTION ARMS LTD.IMPORTER FOR BRITARMS OF ENGLAND
ACT - ACTION/ACTION 1920 MODELMADE BY MODESTO SANTOS
ADK - AD-TEK OF TALLAHASSEE, INC. TALLAHASSEE, FLORIDA
ADA - ADAMS
AZD - ADAMS ARMS, LLC ; PALM HARBOR, FLORIDA
AD0 - ADAMS GUNWORKS, LLC LIBERTY, MISSOURI
ADR - ADCOR INDUSTRIES, INC. BALTIMORE, MD.
ADX - ADDAX TACTICAL INC. SAN FERNANDO, CA
ADQ - ADEQ FIREARMS COMPANY TAMPA, FLORIDA
ADL - ADLER/ADLERWAFFENWERKE
AVE - ADVANCE MANUFACTURING TACTICAL (AMTAC,INC) SALT LAKE,UT
AVC - ADVANCED ARMAMENT, GEORGIA; MAKER OF SILENCER AND OTHER FIREARM ACCESSORIES
ADV - ADVANCED ARMAMENTS, INC., TEXAS; MAKER OF RIFLES
AVD - ADVANCED COMBAT, LLC TULSA, OK
ACG - ADVANCED COMBAT TECHNOLOGIES, INC. (ACT, INC.) ELMA, WA
ADD - ADVANCED DEFENSE SYSTEMS (TRADE NAME-ADS) PHOENIX, ARIZONA
ADG - ADVANCED GUN WORKS, LLC; ROANOKE, TEXAS
APM - ADVANCED PRECISION MACHINING ; MERIDIAN, IDAHO
ASA - ADVANCED SMALL ARMS INDUSTRIES SOLOTHURN SWITZERLAND
AV0 - ADVANCED TACTICAL ORDNANCE,LLC(ATO) ABBEVILLE,MS
AVF - ADVANCED TACTICS, LLC (TACTICAL & HUNTING FIREARMS) LAKE CITY, MICHIGAN
AAW - ADVANCED WEAPON SYSTEMS LLC%GREENWOOD INDIANA
DCM - ADVANCED WEAPONS & FIREARMS, LLC (DANGER CLOSE MFG.) NEW SMYRNA BEACH, FLORIDA
AVW - ADVANCED WEAPONS TECHNOLOGY,LLC RUSSELL,KENTUCKY
ATG - ADVANTAGE ARMSST. PAUL, MINNESOTA
API - AERO PRECISION INC., TACOMA , WASHINGTON
AEM - AESIR ARMS LLC%STUART FLORIDA
AET - AETNA ARMS CO.
AF - AFGHANISTAN CODE BY COUNTRY IF MAKE CAN NOT BE DETERMINED
AFT - AFT BLAINE, ME
AAE - AGAINST ALL ENEMIES, LLC A.A.E. LAKE HAVASU CITY, ARIZONA
AGW - AGAWAM ARMS
AAG - AGENCY ARMS, LLC VENTURA, CA
CNR - AGILE VENTURES, LLC (COSAINT ARMS) FLAT ROCK, NC
SAX - AGNERSEE SAXHOJ PRODUCT
AGP - AGP ARMS, INC TEMPE, ARIZONA
AGM - AGRAMONTE, EDIMPORTER ONLY
AGR - AGRISTIN-FARAR-ESPANA
AGA - AGRUPACION S.T. ARME SPAIN
IAG - AGSEE GALESI
AG - AGUASCALIENTES CODE BY COUNTRY IF MAKE CAN NOT BE DETERMINED
AGT - AGUIRRE Y ARANZABAL
AYG - AGUIRRE Y CIA
ADC - AGUIRRE, PEDRO AROSAMFR. OF SHOTGUNS
AGU - AGURO
AIK - AIKEN, HENRY
APD - AIM, INCORPORATED; PARTON, MARYLAND
AIC - AIMCO HOUSTON, TX SEE ARMAS INTERNATIONAL MANUFACTURING CO.
AIR - AIRBORNE ARMS, LLC BLAINE, MN
AIT - AIRTRONIC USA, INC. ELK GROVE VILLAGE, ILLINOIS
MED - AJAX ARMY MFG BY MEACHAM
CRE - AJAX MFG BY CRESCENT
DQ - AK CHIN INDIAN COMMUNITY OF MARICOPA (AK CHIN) INDIAN RESERVATION, ARIZONA USE COUNTRY CODE IF MAKE CAN NOT BE DETERMINED
ALB - AKAH DISTRIBUTED AND IMPORTED BY ALBRECHT KIND
AKI - AKAI CUSTOM GUNS, LLC SUNRISE, FLORIDA
AKD - AKDAS MAKINA SILAH SANAYI (AKDAS ARMS COMPANY) BEYSEHIR, KONYA TURKEY
AKK - AKKAR SILAH SANAYI TIC, LTD. IZMIR, TURKEY TRADE NAME HATSAN
AKT - AKLIENGESELLSCHAFT
AKX - AKLYS DEFENSE, LLC (MEAUX GUNS) BATON ROUGE, LA
MDI - AKM MODEL OF MAADI
AKU - AKUS SILAH SAN TIC AS KONYA, TURKEY
AL - ALABAMA CODE BY COUNTRY IF MAKE CAN NOT BE DETERMINED
DX - ALABAMA-COUSHATTA TRIBES OF TEXAS USE COUNTRY CODE IF MAKE CAN NOT BE DETERMINED
DY - ALABAMA-QUASSARTE TRIBAL TOWN, OKLAHOMA USE COUNTRY CODE IF MAKE CAN NOT BE DETERMINED
ALM - ALAMO ALSO BRAND NAME OF STOEGER ON ROHN REVOLVER AND ALAMO LEATHER CO, ON HIGH STANDARD REVOLVER
H0D - ALASKA BRAND NAME OF HOOD FIREARMS CO
AK - ALASKA CODE BY COUNTRY IF MAKE CAN NOT BE DETERMINED
AA - ALBANIA CODE BY COUNTRY IF MAKE CAN NOT BE DETERMINED.
AB - ALBERTA CODE BY COUNTRY IF MAKE CAN NOT BE DETERMINED
ALG - ALBERTA TACTICAL RIFLE SUPPLY (MAGNUM MACHINE, LTD.) CALGARY, ALBERTA, CANADA
STQ - ALBIN WALL
ENF - ALBION MFG BY ENFIELD
ALY - ALCHEMY ARMS COMPANY; AUBURN, WASHINGTON
ADS - ALDENS (CHIEFTAN)MFD. BY SAVAGE
UBE - ALDO UBERTI MFG OF REVOLVERS
MRA - ALEX MARTIN, LTD.DISTRIBUTOR/IMPORTER
AXL - ALEX PRO FIREARMS, LLC ALEXANDRIA, MN
AXA - ALEXANDER ARMS; RADFORD, VA
AJ0 - ALEXANDER JAMES ORDNANCE
STX - ALEXANDER STOCKING & CO.
APF - ALEXANDRIA PRO FAB CO. INC. AKA ALEX PRO FAB ALEXANDRIA, MN
HAA - ALEXBRAND OF HOPKINS & ALLEN
ALX - ALEXIA MFG OF REVOLVERS
ALF - ALFATRADEMARK OF ADOLF FRANK CO.
AN - ALGERIA USE COUNTRY CODE IF MAKE CAN NOT BE DETERMINED
AIY - ALIEN ARMORY TACTICAL, LLC SAINT CHARLES, MO
ALA - ALKAR/ALKARTASUNA BRAND NAMES OF ALKARTASAUN FABRICADE ARMAS
AL0 - ALL AMERICAN ARMORY, LLC BOW, WASHINGTON
ALN - ALLEN
ALW - ALLEN & WHEELOCK
IAL - ALLEN AMERICAN IMPORTED GUNSUNS
ALE - ALLEN, ETHAN, & CO.
AAT - ALLIED ARMAMENT, INC; SCAPPOOSE, OREGON
ALS - ALLIED ARMS
ALL - ALLIES
ALI - ALLSTAR TACTICAL, LLC; WEBSTER, NEW YORK
WPM - ALOHA IDAHO CORP. (WEAPONSMART) LEWISTON, IDAHO
PER - ALONZO D. PERRY
APS - ALPH-PROJ SPOL S.R.O. (DBA) BRNO ARMS, BRNO ALFA AND ZH BREN CZECH REPUBLIC
AHA - ALPHA ARMS; FLOWER MOUND, TX
AEY - ALPHA EPSILON SYSTEMS, LLC HOUSTON, TX
ALP - ALPINE INDUSTRIES
FCL - ALPINEMFD. BY FIREARMS CO. LTD.
IP - ALREADY BEING USED ON III CODE TABLE
XY - ALREADY BEING USED ON III CODE TABLE
AAB - ALTOBELLI ARMS TURKEY
A0R - ALTOR CORPORATION PHOENIX, ARIZONA
AMR - AMADEO ROSSI & CO.
B0I - AMANTINO, E. R.PREVIOUSLY BOITO. GUNS ARE NOWMARKED ERA
ABA - AMBROSE ARMORY ESCONDIDO, CA
AFI - AMBUSH FIREARMS INC. BLACK CREEK, GA
ATN - AMBUSH TACTICAL, INC. GARDEN CITY, IDAHO
AEE - AMEETEC; GILBERT, ARIZONA
WAT - AMELUNG MODEL OF WARRANT
BLG - AMERICA BRAND NAME OF BLISS & GOODYEAR
AMA - AMERICA S. A.
ATY - AMERICAN ARMAMENT COMPANY LLC DENISON, TX
AAM - AMERICAN ARMS & AMMO
AM - AMERICAN ARMS CO OR AMERICAN SAMOA (ISLANDS) USE COUNTRY CODE IF MAKE IS NOT DETERMINED
AAI - AMERICAN ARMS INTERNATIONAL SALT LAKE CITY,UT
AER - AMERICAN ARMS NORTH KANSAS CITY,MISSOURI
AAR - AMERICAN ARMS, INC.GARDEN GROVE, CA
AAD - AMERICAN ARMS/DELTA SPARKS,NEVADA
T0W - AMERICAN BOY BRAND NAME OF TOWNLEY METAL CO
BR0 - AMERICAN BROWNING
IJ - AMERICAN BULLDOG BRTAND OF IVER JOHNSON
AMC - AMERICAN CLUBMFR. OF SHOTGUNS
AMF - AMERICAN CRAFTSMEN
ADF - AMERICAN DEFENSE MANUFACTURING, LLC NEW BERLIN, WI
AMJ - AMERICAN DERRINGER CO.WACO, TX
AMD - AMERICAN DERRINGER CORP.DISTRIBUTED BY EARLY & MODERNFIREARMS
N0B - AMERICAN EAGLE BRAND NAME OF NOBLE
AFA - AMERICAN FIGHTER ARMS (IBRAHIM AGIL) SANTA ROSA, CALIFORNIA
AMH - AMERICAN FIREARMS CORP.
AFC - AMERICAN FIREARMS MANUFACTURING COMPANY; GRANTSVILLE, UTAH
AFM - AMERICAN FIREARMS MFG. CO..38 SINGLE-SHOT DERRINGER ANDSTAINLESS .25 AUTOMATIC
AFF - AMERICAN FRONTIER FIREARMS
MGG - AMERICAN GUN COMPANY, LLC (MCGOWEN GUN WORKS) KALISPELL, MT
AIM - AMERICAN IMPORT CO. (TAICO)IMPORTER ONLY
AII - AMERICAN INDUSTRIES INC.MODEL CALICO
AAP - AMERICAN PRECISION ARMS, LLC; JEFFERSON,GEORGIA
AMW - AMERICAN S & W
AAH - AMERICAN SHOOTING CENTER, INC. (ASC, INC.) SAN DIEGO, CA
APT - AMERICAN SPIRIT ARMS CORP.
ANT - AMERICAN SPIRIT ARMS, LLC; SCOTTSDALE, AZ (NEW COMPANY;LLC MAKES THIS NEW
AMI - AMERICAN STANDARD TOOL CO.MFR. OF REVOLVERS
AMM - AMERICAN STEAM WORKS
ATP - AMERICAN TACTICAL IMPORTS ROCHESTER, NY
ATU - AMERICAN TACTICAL OUTFITTERS, LLC (KILROY'S) WEST SACRAMENTO, CALIFORNIA
AVG - AMERICAN VINTAGE GUN & PAWN, INC. (GUN POINT) BRADENTON, FL
AWP - AMERICAN WEAPON SYSTEMS; RINDGE, NEW HAMPSHIRE
AWC - AMERICAN WEAPONS CORP.IMPORTER
AWR - AMERICAN WESTERN ARMS, ITALIA-AWA ITALY%GARDONE, ITALY
AWA - AMERICAN WESTERN ARMS; DEL RAY BEACH, FLORIDA
THE - AMERICAN, THE
AAZ - AMERICANA ARMS, LLC BEEVILLE, TEXAS
ACS - AMERIGO COSMI
AES - AMERO ESPEEIALISTAS REUNIDAS
AMN - AMES, N. P.
AMB - AMMO BROS CERRITOS, CA.
AM0 - AMMO DUMP INTERNATIONAL, LLC MADISON, FLORIDA
BEN - AMR MODEL MODEL OF BERNARDELLI
AMS - AMSDEN, R. W.
AMT - AMT (ARCADIA MACHINE & TOOL)MFR.FRAMES AND STAINLESS PISTOLS
AIE - AMTEC 2000 GARDNER,MA; MANUFACTURES REVOLVERS
AMU - AMUATEGUI, MARTIN
ANN - ANARCHY ARMS (STORM PRECISION, LLC) VENTURA, CALIFORNIA
ANA - ANATOLIA MFG. CO ORLANDO, FL
ANC - ANCIENS ESTABLISHMENTS PIEPER
EXT - ANCION-MARXMFR. OF EXTRACTEUR
ADM - ANDERSON MANUFACTURING; HEBRON, KENTUCKY
AD - ANDORRA CODE BY COUNTRY IF MAKE CAN NOT BE DETERMINED
BNE - ANDREA BENETTI
FYR - ANDREW FYRBERG & CO.EARLY MFR.
ACN - ANDRO CORP INDUSTRIES (ACI); OCOEE, FLORIDA _ADDED/ASSIGNED 7/8/15
AND - ANDRUS & OSBORN
BA0 - ANGELO & EMELIS BONIOTTI
ANZ - ANGELO ZOLI NOT TO BE CONFUSED WITH ANTONIO ZOLI
A0 - ANGOLA USE COUNTRY CODE IF MAKE CAN NOT BE DETERMINED
AGX - ANGSTADT ARMS, LLC; CHARLOTTE, NORTH CAROLINA
AE - ANGUILLA CODE BY COUNTRY IF MAKE CAN NOT BE DETERMINED.
AAA - ANN ARBOR ARMS ANN ARBOR, MI
ANS - ANSCHUTZ
ANY - ANSON & DEELEYMFR. OF SHOTGUNS
A0T - ANSON TACTICAL ARMS, LLC WADESBORO, NC
AI - ANTIGUA & BARBUDA (FORMERLY ANTIGUA) CODE BY COUNTRY IF MAKE CAN NOT BE DETERMINED
AZC - ANTONIO ASPIRI MFR OF PISTOLS, SEE COLON B. H.
ERR - ANTONIO ERRASTI
A0G - ANTONIO GIL & COMPANY; EIBAR, SPAIN
Z0I - ANTONIO ZOLI MFG OF SHOTGUNS
AVL - ANVIL ARMS LLC; LAKELAND FLORIDA
AZI - ANZIO IRONWORKS; ST. PETERSBURG, FL
0V0 - APACHE MADE BY OJANGUREN & VIDOSA
AX - APACHE TRIBE OF OKLAHOMA USE COUNTRY CODE IF MAKE CAN NOT BE DETERMINED
APC - APACHEMFR. OF .45 CARBINES
APH - APAOLOZO/APAOLOZO HERMANOS
H0H - APEXMODEL OF HOLLAND & HOLLAND
APL - APOLLO SEE VOERE
AKL - APPLIED KINETICS, LLC FULLERTON, CA
G0B - AQUA GRAPHIX, LLC (GO BALLISTIC FIREARMS); CLEVELAND, OHIO
ARB - AR-7 INDUSTRIES
VPD - AR15 FACTORY, LLC (VERSAPRO DEFENSE) UNITYVILLE, PENNSYLVANIA
ARY - AR15.COM; HONEOYE, NEW YORK
AFS - AR57, LLC KENT, WASHINGTON
AEA - ARAL ESCOPETAS Y AVA (SPANISH COMPANY)
ARV - ARAMBERRI, VICTOR, & SONS
ABH - ARAMBERRY HERMANOS
ARA - ARANA Y CIEMFR. OF REVOLVERS
DZ - ARAPAHOE TRIBE OF THE WIND RIVER RESERVATION, WYOMING USE COUNTRY CODE IF MAKE CAN NOT BE DETERMINED
AHR - ARCHER MANUFACTURING INC. HUTTO, TX
ARX - ARCHON FIREARMS, INC. LAS VEGAS, NV
ALH - ARCLIGHT PRECISION LLC, FENTON MI
AC - ARCUS COMPANY MFG. OF 9MM SEMIAOTOMATIC PISTOL 94)
AEN - ARDEL ENGINEERING & MANUFACTURING, INC. NEW HOPE, MINNESOTA
ASS - ARDESSA; SPAIN
AE0 - AREA 419 FIREARMS, LLC GRAND RAPIDS, OH
AEZ - AREA 53 RESEARCH & DEVELOPMENT, LLC COLBERT, WASHINGTON
A0A - AREITO-AURIENA
AZZ - ARES ARMS, LLC MEDINA, OHIO
ADE - ARES DEFENSE SYSTEMS BLACKSBURG, VA
AEX - AREX SENTJERNEJ, SLOVENIA
AT - ARGENTINA CODE BY COUNTRY IF MAKE CAN NOT BE DETERMINED
ARG - ARGLER
ARI - ARISAKA
ARJ - ARISTOCRAT BRAND NAME SUPPLE-BIDDLE HDW.OR MODEL OF STEVENS
ARK - ARIZAGA, CASPAR MFG OF SHOTGUNS
ARE - ARIZAGA, EUSEBIO
AYZ - ARIZMENDI Y ZULAICA
ARZ - ARIZMENDI, FRANCISCO
AN0 - ARIZMENDI, NORBERTO
AZY - ARIZONA ARMORY, LLC-PHOENIX, ARIZONA
APP - ARIZONA PRECISION PRODUCTS, LLC (APP, LLC) PHOENIX, ARIZONA
AZR - ARIZONA RIFLEWORKS, LLC GLENDALE, AZ
AZ - ARIZONA USE COUNTRY CODE IF MAKE CAN NOT BE DETERMINED
AZF - ARIZONA'S FINEST POLICE SUPPLY, LLC (AZFPS) MESA, AZ
AR - ARKANSAS USE COUNTRY CODE IF MAKE CAN NOT BE DETERMINED
AAK - ARKAWA KOGYO K. K.MFR. OF RIFLES
AKY - ARKY ARMAMENT,LLC SPRINGDALE,AR
ARF - ARMAF S. A.
AAL - ARMALITE USE ALL ONLY WHEN MODEL IS OTHER THAN LISTED
ARH - ARMAMENT TECHNOLOGY CORP.
GAV - ARMAND GAVAGE
B0Z - ARMAS BOST
AGG - ARMAS DE GUERRA, LLC HARLINGEN, TX
ERI - ARMAS ERBI
GIM - ARMAS GIB-MAXIMO
MRX - ARMAS MARIXA MFG OF SHOTGUNS
PKY - ARMAS PARKEMY, S.L. OR PARKEMY-SPAIN
ATX - ARMATIX GMBH GERMANY ARMATIX U.S. IMPORTER ONLY PER FFL NUMBERCODING IS FOR GERMANY MFG
ADN - ARMED GUNS, TURKEY
RGA - ARMEE MODEL MFD BY ROTH GASSER
AP - ARMENIA USE COUNTRY CODE IF MAKE CAN NOT BE DETERMINED
ARQ - ARMERA
AEC - ARMERIA EL CAZADOR
ALC - ARMERIA EL CIERVO
AAS - ARMI ATIS S. R. L.
DZI - ARMI DESENZANI S.N.C. BRESCIA, ITALY
AEF - ARMI E & F, ITALY
AFP - ARMI F.LLI POLI , ITALY (MODELS:ONIX, RUBY CALIBER:28, 410
FBR - ARMI FABRI MFR OF SHOTGUNS
GUT - ARMI GUISEPPE TANFOGLIO SAME COMPANY AS FRATELLI TANFOGLIO
JAE - ARMI JAEGER/ARMI JAGER IMPORTED BY NAVY ARMS CORP
MFR - ARMI MAROCCHI ITALY
SBI - ARMI SABATTI MFR OF SHOTGUNS
ASM - ARMI SAN MARCOREPLICAS OF ANTIQUES
ASP - ARMI SAN PAOLO
ASB - ARMI SPORT; BRESCIA, ITALY-MAKER OF REPRODUCTION FIREARMS
ATZ - ARMI TECNICHE DE EMILIO BRESSICIA, ITALY
ARC - ARMIGAS-COMEGA
ARM - ARMINEX SCOTTSDALE, AZ
ARN - ARMINIUS NOT A MAKE BUT A BRAND MFD. BY HERMAN WEIHRAUCH,F. I. E. & OTHERS
AIN - ARMITAGE INTERNATIONALSENECA SC
AAY - ARMORY DYNAMICS (THOMPSON, DWAIN); MARIANNA, FLORIDA
AGC - ARMORY GUN CO.MFR. OF SHOTGUNS
AYY - ARMORY, LLC KRESGEVILLE, PENNSYLVANIA
IAR - ARMOTECNIA MFR OF SHOTGUNS
ATH - ARMS TECHNOLOGY
AAN - ARMSAN SILAH SANAYI-TURKEY
ACA - ARMSCO (ARMS CO, ARMS CORP OF AMERICA) CEASED MFG IN 1976, FORMERLY MAK/ARO-RETIRED CODE NASHVILLE, TN
ACR - ARMSCOR (ARMAMENT CORP OF SOUTH AFRICA) SOUTH AFRICA
SQB - ARMSCOR OF THE PHILIPPINES (SQUIRES BINGHAM) PHILIPPINES
APR - ARMSCOR PRECISIONIMPORTER
ACP - ARMSCORP USA (ARMSCORP OF AMERICA) BALTIMORE, MD
AMP - ARMSPORTIMPORTER
EA - AROOSTOOK BAND OF MICMAC INDIANS OF MAINE USE COUNTRY CODE IF MAKE CAN NOT BE DETERMINED
MAY - ARQUEBUSIERMODEL OF MAYOR
AZB - ARRIETA & AZCOAGA IMPORTED BY GALESI
ARP - ARRIOLA
AC0 - ARRIZABALAGA, CALIXTO
EAS - ARROSTEGUI, EULOGIO
ARW - ARROW ARMS; MACON GEORGIA; AR15 TYP FIREARMS OR RECEIVERS
RSE - ARSENAL COMPANY-PRIVATE FIRM; MFGR OF PISTOLS
TUA - ARSENAL DE TULA
ARD - ARSENAL DEFENSE, LLC HUEYTOWN, ALABAMA
AFR - ARSENAL FIREARMS GROUP GARDONE, ITALY
ANL - ARSENAL INC.LAS VEGAS, NEVADA DO NOT CONFUSE WITH: ARSENALOF BULGARIA OR ARSENAL USA
ASL - ARSENAL USA LLC; HOUSTON, TX TRADE NAME GLOBAL TRADES INC OR ARMORY USA LLC
ART - ARTIGIS
NE - ARTILLERIE INRICHTIGENMILITARY ARSENAL OR HOLLAND (NETHERLANDS) USE COUNTRY CODE IF MAKE CAN NOT BE DETERMINED
ATA - ARTISTIC ARMS MFG OF RIFLES
AJ - ARUBA (NOW INDEPENDENT OF NETHERLANDS ANTILLES) CODE BY COUNTRY IF MAKE CAN NOT BE DETERMINED
ARU - ARVA
ASF - ASA FIREARMS (CHRISTIAN, DL) GARDEN GROVE, CA
ASC - ASCASO, F.
ACE - ASCEND ARMORY MESA, AZ
ZAA - ASCENSIO ZABALA
ADP - ASERMA; SOUTH AFRICA (MODEL NAME OF GUN IS: ADP-AUTOMATIC DEFENSE PISTOL) PER ATF MICHELE HUMPHREYS 10/24/07
AH - ASHMORE & CARTIER ISLANDS, TERRITORY OF (AUSTALIAN EXTERNAL TERRITORY) CODE BY COUNTRY IF MAKE CAN NOT BE DETERMINED
ASH - ASHTON (P. H. OR W.)
ASI - ASI GUNS TURKEY
APN - ASPEN CONTROLS INC. AKA ACI COSTA MESA, CA
AW0 - ASSAULT WEAPONS OF OHIO LLC BEAVERCREEK, OH
GV - ASSINIBOINE AND SIOUX TRIBES OF THE FORT PECK INDIAN RESERVATION, MONTANA USE COUNTRY CODE IF MAKE CAN NOT BE DETERMINED
ASR - ASTAR; SPANISH MANUFACTURER
AS0 - ASTON (W. OR H.)
AST - ASTRA
ASD - ASTRA SA DEFENSE SION, SWITZERLAND
AWL - ASYLUM WEAPONRY, LLC SAINT MARY'S, PA
ATM - ATA ARMS; ISTAMBUL, TURKEY
ATC - ATC
SKB - ATHENA SKB FIREARMS COMPANY
AGL - ATKIN, GRANT & LANG
AFE - ATLAS FORCES KONYA, TURKEY
AA0 - ATLAS GUNWORKS, INC. CHARLOTTE, VERMONT
ATL - ATLASIMPORTER/DISTRIBUTOR
AAX - ATOMIC TACTICAL, INC. BLOOMINGTON, MINNESOTA _FIREARM-ADDED/ASSIGNED 9/10/15
FEG - ATTILA AUTO LOADING PISTOL MFG BY FEG UNION
XXA - ATX ARMORY, LLC AUSTIN, TEXAS
WCA - AUBURN ARMS (W.C. ANDERSON) AUBURN,INDIANA
MDA - AUDAX BRAND D'ARMES DES PYRENEES TRADE NAME LE SANS PARIEL _MANUFACTURE D'ARMES DES PYRENEES FRANCAISE
AUZ - AUGER PRECISION FIREARMS (LEON AUGER) LEVITTOWN, PENNSYLVANIA
FRG - AUGUST FRANCOLETTE CO.
FTR - AUGUST FRANCOTTE MFR OF SHOTGUNS
ME - AUGUST MENZ OR MAINE USE COUNTRY CODE IF MAKE CAN NOT BE DETERMINED
SHN - AUGUST SCHNLE-ALSO SEE REFORM
AGS - AUGUST SCHULER
AUA - AURORA
ASN - AUSTEN MILITARY WEAPONS SEE STEN
AIA - AUSTRALIA ARMS INTERNATIONAL , AUSTRALIA
AS - AUSTRALIA CODE BY COUNTY IF MAKE CAN NOT BE DETERMINED
ATR - AUSTRALIAN ARMS
STU - AUSTRALIAN AUTOMATIC ARMS TASMANIA,AUSTRALIA
ADI - AUSTRALIAN DEFENSE INDUSTRIES; AUSTRALIA
AU - AUSTRIA CODE BY COUNTRY IF MAKE CAN NOT BE DETERMINED
TMW - AUTAUGA ARMS, INC (TMW ENGINEERING) CALIFORNIA (WELSCH 32 CAL)BARREL/FRAME IS MARKED 32ACP-TMW-GARD-CA-USA)
AUQ - AUTO MAGSEE T.D.E. OR JURRAS
AT0 - AUTO NINE CORP. PARMA, ID
A0C - AUTO-ORDNANCE CORP.MFR. OF SUBMACHINE GUNS & SEMI-AUTOMATIC RIFLES
UNV - AUTO-WING SHOTGUN MODEL OF UNIVERSAL
AUR - AUTOGRADE
AU0 - AUTOMATIC ARMSSOUTH CAROLINA
AUM - AUTOMATIC MODEL 1924
AUP - AUTOMATIC PISTOLE ZKP MILITARY WEAPONS
AUT - AUTOMATIQUE FRANCAISE SEE SOCIETE D'ARMES
AUU - AUTONOMOUS ARMORY, LLC THE WOODLANDS, TEXAS
AVT - AVANT INDUSTRIES
AVU - AVCU SILAH SANAYI-TURKEY
ANG - AVENGER REVOLVERS
AVI - AVION/AVION PISTOLET MSDE BY AZPIRI
GUS - AVK-BVSEE GUSTLOFF
AVS - AVSAN AV SANAYI, TURKEY
AWI - AWI; EATON, COLORADO
AXC - AX TACTICAL, LLC YORKVILLE, NY
AXX - AXELSON TACTICAL, LLC; MINDEN, NEVADA ADDED/ASSIGNED 10/22/15
AXE - AXIAL PRECISION, LLC BOISE, IDAHO
AXM - AXIS MANUFACTURING (LARSON_SYSTEMS)LLC, SPOKANE VALLEY,WA
AV - AZERBAIJAN USE COUNTRY CODE IF MAKE CAN NOT BE DETERMINED
AZT - AZIMUTH TECHNOLOGY, LLC (AZT TECHNOLOGY) NAPLES, FLORIDA
AQ - AZORES ISLANDS USE COUNTRY CODE IF MAKE CAN NOT BE DETERMINED
BHA - B & H SMALL ARMSMFR. OF HANDGUNS AND RIFLES
BMT - B & M TACTICAL FIREARMS; KALAMAZOO, MICHIGAN
BNB - B N B ARMORY, LLC WHITE CITY, OREGON
BDT - B&D INNOVATIVE TOOLS (DAVID M. THROWER) SANTA ANA,CA
BBH - B&H ARMS (BARNHART ENTERPRISES, LLC) OCEANSIDE, CALIFORNIA
BAC - B. A. CO.BACON ARMS CO.
BCA - B. C. AUTOMATIC
BFA - B. F. ARMS MANUFACTURER
JSN - B. F. JOSLYN MFR OF CIVIL WAR RIFLES
BHP - B. H.
VIG - B. HUEY SERVICES, LLC (VIGILANT ARMS) JACKSONVILLE, FLORIDA
SRY - B. SEARCY & COMPANY, BORON, CALIFORNIA
BWA - B.WEST IMPORTS INCTUCSON, AZ; MANUFACTURES AK-TYPE RECEIVERS
FNB - BABY BROWNING_ (FABRIQUE NATIONALE-FN HERSTAL)
BAY - BABY DRAGOON VARIOUS MFGS INCLUDING COLT IN EARLY 1800'S
BH - BABY HAMMERLESS MODEL OF SEDGLEY OR VARIOUS OTHER MFGS BELIZE USE COUNTRY CODE IF MAKE CAN NOT BE DETERMINED
BAB - BABYVARIOUS MFRS.
BKB - BACKBONE TACTICAL,LLC_ COLORADO SPRINGS,CO
BDS - BAD ASS TACTICAL (JORDAN M. ARNOLD) HOLDEN, UTAH
XC - BAD RIVER BAND OF LAKE SUPERIOR TRIBE OF CHIPPEWA INDIANS OF THE BAD RIVER RESERVATION,WISCONSIN USE COUNTRY CODE IF MAKE CAN
BLE - BADELLA CUSTOM (BADELLA, MICHAEL JOHN) MADERA, CA
BDB - BADER & BROTHERS; PAKISTAN
BD0 - BADGER ORDNANCE LLC NORTH KANSAS CITY, MO.
BDR - BADROCK TACTICAL (WEBB1CAPITAL, INC.) SAN JUAN CAPISTRANO, CA
BFD - BAFORD ARMS BRISTOL,TN; MFR. "THUNDER" MULTI-CALIBER DERRINGER
BD - BAHAMAS, THE USE COUNTRY CODE IF MAKE CAN NOT BE DETERMINED
BHI - BAHIA TWO-BARREL PISTOLS
BE - BAHRAIN/BAHREIN USE COUNTRY CODE IF MAKE CAN NOT BE DETERMINED
BKL - BAIKAL MFG OF SHOTGUNS
BAI - BAILEY, THOMAS
BA - BAJA CALIFORNIA (NORTHERN SECTION) USE COUNTRY CODE IF MAKE CAN NOT BE DETERMINED
BJ - BAJA CALIFORNIA SUR (SOUTHERN SECTION) USE COUNTRY CODE IF MAKE CAN NOT BE DETERMINED
SMC - BAKER BRAND NAME OF L.C. SMITH GUN CO.
BAK - BAKER GUN CO.IMPORTED OR MFD. BY CRESCENT
BK - BAKER ISLAND USE COUNTRY CODE IF MAKE CAN NOT BE DETERMINED
BGC - BAKERSFIELD GUN CLUB; BAKERSFIELD, CALIFORNIA- AR15 TYPE _FIREARM
BAW - BALDWIN CO.MFR. OF SHOTGUNS
BLD - BALL & WILLIAMSMFD. BY C. H. BALLARD
BAF - BALLARD & FAIRBANKS
MAR - BALLARD (RIFLE)MODEL OF MARLIN
BAA - BALLARD ARMS LYNNDYL, UT .50 CALIBER RIFLE
BRC - BALLARD RIFLE & CARTRIDGE, LLC CODY, WY
HIS - BALLESTER-MOLINA MFG.BY HAFDASA
BAD - BALLESTER-RIGUAD
BLZ - BALLISTIC ADVANTAGE, LLC APOPKA, FLORIDA
BST - BALLISTIC SOUNDS TACTICAL SUPPLY, LLC (BSTS, LLC) ATHENS, GEORGIA
BAM - BALTIMORE ARMS CO.
BNS - BANAS ARMORY, LLC HERMITAGE, PA
BNC - BANE CORP. (VILLAGE GOLDSMITH, INC.) CRANSTON, RI
BUP - BANG UPTRADE NAME GRAHAM & HAINES CO.
BL - BANGLADESH USE COUNTRY CODE IF MAKE CAN NOT BE DETERMINED
BNU - BANSNERS ULTIMATE RIFLES; ADAMSTOWN, PA
BER - BANTAM MODEL MFG BY BERETTA
BSP - BAR-STO PRECISION TWENTY-NINE PALMS, CA
BB - BARBADOS USE COUNTRY CODE IF MAKE CAN NOT BE DETERMINED
BRT - BARETT FIREARMS MANUFACTURING 50 CAL RIFLES; MURFEESBORO,TN
BAE - BARKER, T.SOLD BY CRESCENT, H & D FOLSOM,AND IVER JOHNSON
BM0 - BARNES FIREARMS (MICHAEL O. BARNES) CARSON CITY, NEVADA
BPM - BARNES PRECISION MACHINE,INC.APEX NORTH CAROLINA
BUQ - BARONESSMFD. BY BUTLER ASSOCIATES, INC.
BLR - BARRELS AND ARROWS,LLC MARSHALL, MN
BAG - BARRENECHEA & GALLESTEGUE AUTO PISTOLS
BLT - BARTLETT ENTERPRISES, INC; HILLSBORO, OREGON
BZM - BARTZ MANUFACTURING, INC. (BRENTON USA, INC.) LANSING, MI
BNM - BASCARAN, MARTIN A.
BAS - BASCULANT
ECE - BASQUEMODEL OF ECHASA-EIBAR ALSO SEE;ECHASA-ECHAVE ARIZMENDI
BF - BASSAS DA INDIA (FRENCH POSSESSION) USE COUNTRY CODE IF MAKE CAN NOT BE DETERMINED
BME - BAT MACHINE CO., INC, RATHDRUM, IDAHO
BAT - BATAVIA/BATAVIA LEADER MODEL OF CRESCENT OR BAKER
BZI - BATTISTA RIZZINI; MARCHENO, ITALY
BTL - BATTLE ARMS DEVELOPMENT HENDERSON, NV
BBT - BATTLE BORN TACTICS, LLC RENO, NEVADA
BZB - BATTLE RIFLE COMPANY SEABROOK, TEXAS
BAU - BAUER FIREARMS CORP.MFR. OF PISTOLS
BRL - BAUER, KARL-DISTRIBUTOR
EB - BAY MILLS INDIAN COMMUNITY, MICHIGAN USE COUNTRY CODE IF MAKE CAN NOT BE DETERMINED
HAJ - BAYARD MADE BY HAERENS TOJHUS
BSF - BAYERISCHE SPORTWAFFENFABRIK
BAZ - BAZOOKA BROTHERS MANUFACTURING RUSSIAVILLE, INDIANA
BCE - BC ENGINEERING, LLC; RUSSELLVILLE, TENNESSEE
BCI - BCI DEFENSE LLC BREMEN, IN
BCW - BCW MANUFACTURING NORTH BRANCH, MN
BDY - BE READY ENTERPRISES, LLC FREDERICKSBURG, VIRGINIA
BFI - BEAN FIREARMS COMPANY, LLC MURRAY, UTAH
BBL - BEAR ARMS, LLC WINDSOR, COLORADO
BAL - BEAR CREEK ARSENAL SANFORD, NC
BEA - BEAUMONT-VITALI
BKD - BECK DEFENSE, LLC SPRINGTOWN, TEXAS
BEC - BECKER & HOLLANDER
BCK - BECKERMFR. OF SHOTGUNS
BDL - BEDELL CUSTOM (DANIEL E. BEDELL, II) LANCASTER, NY
BBE - BEEBE ARMS CO.BRAND OF MARLIN OR REMINGTON
BMN - BEEMAN
BEE - BEESLEY
BEI - BEISTEGUI
BY - BELARUS USE COUNTRY CODE IF MAKE CAN NOT BE DETERMINED
BJA - BELATEGUI, JUAN ANTONIO
BG - BELGIUM USE COUNTRY CODE IF MAKE CAN NOT BE DETERMINED
BHE - BELKNAP HARDWARE USE BHE ONLY WHEN MODEL IS OTHER THAN LISTED
BPR - BELL PRECISION RIFLES, LOCATION: MILROY,INDIANA
BTR - BELLATOR ARMAMENT PEORIA, ARIZONA
LBU - BELLERI, LUIGI
BJT - BELLMORE-JOHNSON TOOL CO.
BTF - BELMONT FIREARMS MFR OF SHOTGUNS
BEJ - BEN FRANKLIN
BBW - BENBOW CITY SPORTS (MAAG,TG) WOOD RIVER,ILLINOIS
BNL - BENELLI S.P.A.
RET - BENEMERITA BRAND OF RETOLAZA
BTA - BENET ARMS IMPORTER
DH - BENIN (FORMERLY DAHOMEY) USE COUNTRY CODE IF MAKE CAN NOT BE DETERMINED
BJM - BENJAMIN MFG OF AIR GUNS
BZA - BERASALUZE AREITIO AURTENA MFR OF PISTOLS
BBC - BERBEN CORP.IMPORTER OF BERETTA
BEF - BERDANEARLY ARMS MFR.
BEQ - BERENT STEEL CO.IMPORTER ONLY
BYC - BERESTIAN & CIA
FII - BERETTA USA CORP.FORMERLY F. I. INDUSTRIES
BBI - BERETTA-BENELLI IBERICA S.A. TRESPUENTES, SPAIN
BGB - BERGARA EUROPE BERGARA, SPAIN
BEB - BERGEREON
BEG - BERGMANN, THEODOR
BKF - BERIKA ARMS (FEDARM TK) ANTALYA, TURKEY
BEK - BERKSHIRE
BSW - BERLIN SUHLER WAFFEN
BE0 - BERNARDON-MARTIN
BED - BERNEDO
BEW - BERNS WHOLESALE IMPORTER /DISTRIBUTOR
AEI - BERSA/BERSA PICCOLA MADE BY INDUSTRIA ARGENTINA MAHELY BRAND RIFLES ETC INDUSTRIA ARGENTINA MARKING ON GUNS IN ARGENTINA
BSL - BES-T OF-ALBRAND OF SHOTGUN
BSA - BESAMFD. BY BSA (COPY OF TWO-BARREL.37 MACHINE GUN)
BSM - BESCHI, MARIOMFR. OF SHOTGUNS
BTW - BEST OF THE WEST PRODUCTIONS, LLC; CODY, WYOMING
BCG - BETTER FIREARM DESIGNS (BEN'S COIN & GUN SHOP, INC.) DELAND, FLORIDA
BTT - BETTINSOLI TARCISIO; GARDONE, ITALY
BGD - BG DEFENSE CO., LLC GRAND RAPIDS, MICHIGAN
BHS - BHA INC. DBA BLACK HORSE ARSENAL HALSEY, OR
BN - BHUTAN USE COUNTRY CODE IF MAKE CAN NOT BE DETERMINED
BBA - BIG BEAR ARMS IMPORTER
R0M - BIG DBRAND NAME OF RHOEM GESELLSCHAFT
BHN - BIG H0RN ARMS; WATERT0WN, SD
BHR - BIG HORN ARMORY, INC. CODY, WYOMING
BMM - BIGHAMMER ARMORY (MOREY, HOWARD M.) MOORE, OKLAHOMA
BII - BII SALES
BIJ - BIJOU
BWC - BILL WISEMAN & COMPANY, INC.; COLLEGE STATION, TEXAS
BCS - BILL'S CUSTOM AUTOMATICS, INC. SHELBY, MS
BIL - BILLET RIFLE SYSTEMS, LLC%BRS GARRISON RIFLE WORKS CARSON CITYNEVADA
DAE - BIRD HUNTERMODEL OF DARNE SHOTGUNS
BIH - BISHAMON ARMS, LLC HOT SPRINGS NATIONAL PARK, ARKANSAS
BHM - BISHOP AMMUNITION, MANUFACTURING, LLC NORTH HIGHLANDS, CA
SCR - BISON BRAND OF HERBERT SCHMIDT
BIT - BITTNER, GUSTAV
BJ0 - BJORGUM
BTC - BLACK ACES TACTICAL WINTER GARDEN, FL
BKK - BLACK ANKLE MUNITIONS, LLC SCOTTSBORO, ALABAMA
BBF - BLACK BOAR RIFLES, LLC GEORGETOWN, TEXAS
BCP - BLACK CREEK PRECISION, LLC JACKSON, FL
BCC - BLACK COLLAR ARMS, LLC AUSTIN, TX
BDI - BLACK DAWN INDUSTRIES LLC. AKA BLACK DAWN SEDALIA MO
SSN - BLACK FOREST GUNWURKS, LLC (SAS DEFENSE) CORNELIA, GEORGIA
BF0 - BLACK FORGE, LLC ORLANDO, FLORIDA
BKH - BLACK HOG RIFLE COMPANY ABILENE, TEXAS
BKM - BLACK ICE ARMORY, LLC PLEASANT GROVE, UTAH
BLP - BLACK OPS ARMS, LLC CLAREMONT, NEW HAMPSHIRE
BRG - BLACK PRINCE BRAND NAME OF BRIDGE GUN CO
BKR - BLACK RAIN ORDNANCE INC. NEOSHO, MO.
BFB - BLACK RIFLE BOYS LINDSAY, CA
BLA - BLACK RIFLE COMPANY, LLC CLACKAMAS, OREGON
BLF - BLACK RIFLE CUSTOMS, LLC (AMERICAN RESISTANCE) GARRISON, TX
BSU - BLACK SUNDAY TACTICAL (GRAY, RONNIE) RIVERBANK, CA
BKS - BLACK SWAMP FIREARMS, LLC OTTAWA LAKE, MICHIGAN
BWY - BLACK WARRIOR ARMORY ALABASTER, ALABAMA
BLK - BLACK WEAPONS ARMORY, LLC TUCSON, ARIZONA
BLB - BLACKBRIAR, LLC; ALBUQUERQUE, NEW MEXICO _ADDED/ASSIGNED 8/5/15
EC - BLACKFEET TRIBE OF THE BLACKFEET INDIAN RESERVATION OF MONTANA USE COUNTRY CODE IF MAKE CAN NOT BE DETERMINED
BKC - BLACKHAWK CUSTOM LLC PORT ST. LUCIE, FL
BLH - BLACKHEART INTERNATIONAL, LLC PHILIPPI, WV
B0P - BLACKOPS PRECISION/WILDCALL CUSTOM COLUMBIA FALLS, MONTANA
HLS - BLACKOUT ARMS,LLC (HELLSING ARMS) LARGO, FL
BPT - BLACKSHEEP6 TACTICAL, LLC MANHATTAN, KANSAS
BSD - BLACKSWORD LLC KNOXVILLE, TN
BLW - BLACKWATER LODGE & TRAINING CENTER, INC OR BLACKWATER USA MOYOCK, NC
TBS - BLAND, THOMAS, & SONS
BJW - BLASER JAGDWAFFEN GMBH.ISNY/ALLGAU, GERMANY
BGW - BLAYLOCKS GUN WORKS AKA BGW GUN BARREL CITY, TX
BJH - BLUE HEN BRAND NAME OF JELLICA HARDWARE
MSI - BLUE MALLARD MODEL OD MASIERI
BRP - BLUE RIDGE PRECISION GUNWORKS FT. HILL, SC
BLS - BLUEGRASS ARM0RY; RICHM0ND, KY
BLC - BLUMENFELD IMPORTS CO.IMPORTER
BLU - BLUNT & SYMS
BDX - BMADDOX ENTERPRISES,, LLC (SILENCER CENTRAL/BANISH SUPPRESSORS/DAKOTA SILENCERS) SIOUX FALLS, SOUTH DAKOTA
BM - BM MFG OF SHOTGUNS OR BERMUDA USE COUNTRY CODE IF MAKE CAN NOTBE DETERMINED
BML - BMG INC. BEND, OREGON
BMG - BMG, LLC; NEWINGTON, CONNECTICUT (NOT SAME AS BMG,INC MAK/BML BEND, OR
B0B - BOBCAT WEAPONS, INC; PHOENIX, ARIZONA
BBG - BOBERG ARMS CORPORATION WHITE BEAR LAKE, MN.
B0X - BOCK DOUBLE-BARREL PISTOLS
EME - BODYGUARDMFD. BY GERSTENBERGER & EBERWEIN
B0C - BOHICA LOVELAND CO; MFR. AR-15 RIFLES.
BW - BOHNMISCHE WAFFENFABRIK OR BALEARIC ISLANDS USE COUNTRY CODE IF MAKE CAN NOT BE DETERMINED
XP - BOIS FORTE BAND (NETT LAKE) OF CHIPPEWA MINNESOTA USE COUNTRY CODE IF MAKE CANNOT BE DETERMINED
BLL - BOISE TACTICAL, LLC KUNA, IDAHO
B0J - BOJHO YUGOSLAVIAN ARMY MARKS ON BROWNING 1922
BV - BOLIVIA USE COUNTRY CODE IF MAKE CAN NOT BE DETERMINED
B0T - BOLTUN
B0U - BOLUMBURU, GREGORIO
NX - BONAIRE & CURACAO (NETHERLANDS ANTILLES) USE COUNTRY CODE IF MAKE CAN NOT BE DETERMINED
BNZ - BONANZA BACON MFG. CO.
BNA - BOND ARMS GRANBURY TX MAKES REMINGTON TYPEER/UNDER DERRINGER
STA - BONIFACIO ECHEVERRIA SEE STAR
BFC - BONNELL FIREARM CO.
BPD - BOOMER PRECISION,LLC (DAY 2 FIREARMS) SPRING, TEXAS
B00 - BOONE, DANIEL DISTRIBUTED BY BELKNAP HARDWARD SEVERAL MFGRS
B0R - BORCHARDT, HUGO
B0H - BORCHERS
BDN - BORDENS ACCURACY SHOP SPRINGVILLE, PA BENCHREST RIFLES
N00 - BOREALIS (BRIGADIER W/STOCK)MODEL OF NORTH AMERICAN ARMS
BP - BOSNIA AND HERZEGOVENIA (HC FOR REFERENCE ONLY) USE COUNTRY CODE IF MAKE CANNOT BE DETERMINED
HC - BOSNIA USE COUNTRY CODE IF MAKE CAN NOT BE DETERMINED
B0S - BOSS & CO.
BBD - BOSTON BULL DOG
UAC - BOSTWICK BRAUN SHOTGUNS MFG BY UNION ARMS CO.
BT - BOTSWANA USE COUNTRY CODE IF MAKE CAN NOT BE DETERMINED
BQ - BOUVET ISLAND (NORWEGIAN TERRITORY) USE COUNTRY CODE IF MAKE CAN NOT BE DETERMINED
B0Y - BOUYER ARMS, LLC WEATHERFORD, TEXAS
B0W - BOWERS (TRADE NAME) LICENSE UNDER THOMAS A BOWERS. MAKER OF SILENCERS; CORNELIUS, OREGON
BWI - BOWERS INDUSTRIES MFG OF DEFENDER CARBINES
BZD - BOZARD & CO. MFR OF SHOTGUNS
BGG - BP FIREARMS COMPANY, LLC (BERGARA USA/BPI) LAWRENCEVILLE, GEORGIA
BRB - BRANDON
BAV - BRAVO 4 TACTICAL RAMONA, CALIFORNIA
BCM - BRAVO CO., MFG., INC-HARTLAND, WISCONSIN
BRA - BRAZIER
BZ - BRAZIL USE COUNTRY CODE IF MAKE CAN NOT BE DETERMINED
BZS - BRAZOS CUSTOM GUNWORKS (LONDRIGAN, RJ) MORGAN, TEXAS
BTI - BRB TACTICAL SYSTEMS, INC LECANTO, FLORIDA
BDA - BREDAPISTOLS
BRN - BREN SUBMACHINE GUN
BSC - BRESCIA ARMAS
BRE - BRETHREN ARMAMENT, LLC DBA BRETHREN ARMS WEST VALLEY CITY, UT
BRV - BREVETTATE INDUSTRIA ARMI SHOTGUNS
BVZ - BREVEZ-AW.410 GAUGE SINGLE-SHOT SHOTGUN
MTE - BRICE BREEDEN ENTERPRISES, LLC (MACHETE FIREARMS) SULLIVAN, MISSOURI
HUN - BRIDGEPORT ARMS CO.BRAND NAME OF HUNTER ARMS CO.
BGS - BRIDGETOWN GUN SHOP, LLC NESBIT, MISSISSIPPI
BDE - BRIGADE MANUFACTURING, INC. MIAMI, FL
BMI - BRILEY MFG LIC HOUSTON, TX
BRF - BRISTOL FIREARMS CO.
LEH - BRITCH MODEL OF LEE ENFIELD
BC - BRITISH COLUMBIA USE COUNTRY CODE IF MAKE CAN NOT BE DETERMINED
BTE - BRITISH ENFIELD MILITARY SURPLUS
B0 - BRITISH INDIAN OCEAN TERRITORY (DEPENDENT TERRITORY OF UNITED KINGDOM) USE COUNTRY CODE IF MAKE CAN NOT BE DETERMINED
VB - BRITISH VIRGIN ISLANDS USE COUNTRY CODE IF MAKE CAN NOT BE DETRMINED
BRX - BRIXIA (MILITARY MODEL)ITALIAN COPY OF WALTHER
BRZ - BRNO ZBROJOVKA
BDH - BROADHEAD ARMORY WYANDOTTE, MI
BCL - BROCOCK, BROCOCK LIMITED OR BROCOCK SPORTING ARMS _AIR PISTOLS & RIFLES
BRK - BROOKLYN ARMS CO.
BHL - BROTHERS LA ARMS,LLC PONCHATOULA, LA
BRQ - BROWERDUIT
DIX - BROWN BESS (GRICE)MUSKET IMPORTED BY DIXIE GUN WORKS
TBB - BROWN BESS (TOWER)REPLICA
BRW - BROWN MFG. CO.
BNP - BROWN PRECISION INC., LOS MOLINOS, CA. CUSTOMIZER
BB0 - BROWNELL'S, INC. MONTEZUMA, IOWA
M0S - BROWNIE (PISTOL)MODEL OF MOSSBERG
BPC - BRP CORP., CLINTON, MARYLAND
BTH - BRUGGER & THOMET AG, SWITZERLAND
BX - BRUNEI USE COUNTRY CODE IF MAKE CAN NOT BE DETERMINED
FA0 - BRUNO ALBERTI ITALY SEE FALCO
BBN - BRUNO BOLOGNINIGARDONE, ITALY
CSB - BRUNO CASTELLANI MFR OF SHOTGUNS
BRY - BRYCO ARMS
BSS - BS OR B/S
BTZ - BTE USA, LLC (BATTLE TESTED EQUIPMENT) PHOENIX, ARIZONA
BBU - BUBITS GMBH (BB TECHS) OBERPULLENDORF, AUSTRIA
BUF - BUCHANAN GUNSMITHING & CUSTOM FIREARMS, LLC MILFORD, PA
BUC - BUCHEL
BKG - BUCKEYE GUN CO.MFR. OF SHOTGUNS
FHQ - BUCKSKIN SHOTGUN MODEL OF FRANCHI
BUD - BUDDIE ARMS CO.
NMC - BUDISCHOWSKY TP-70MODEL OF NORAMCO
BFF - BUFFALO ARMS CORP.
BUA - BUFFALO ARMS CORP.TONOWANDA, NY
GAA - BUFFALO MADE BY GABILONDO
ECM - BUFFALO SCOUT IMPORTED BY EXCAM
T0F - BUFFALO SCOUT MFD BY FRANCISCO TANFOGLIO;INSCRIBED MADE IN ITALY
BUH - BUHAG
BTM - BUL TRANSMARK LTD TEL AVIV ISREAL
BUI - BULA DEFENSE SYSTEMS (BDSI,INC) CLEVELAND,OH
BU - BULGARIA USE COUNTRY CODE IF MAKE CAN NOT BE DETERMINED
BSE - BULL MOOSE TACTICAL, LLC BOWDOIN, MAINE
BUL - BULLDOG VARIOUS MFG'S
C0E - BULLDOZER MODEL OF CONNECTICUT ARMS & MFG CO
BUE - BULLFIGHTER
FW - BULLSEYE MFG. CO.MFD. BY FOREHAND & WADSWORTH FLANDREAU SANTEE SIOUX TRIBE OF SOUTH DAKOTA USE COUNTRY CODE IF MAKE CAN NOT B
BNK - BUNKER ARMS CUSTOM ELLENTON, FLORIDA
BUG - BURGESS
BU0 - BURGHAM
BUR - BURGO/BURGSMUELLER, KARL IMPORTER / DISTRIBUTOR ONLY
UV - BURKINA OR BUKINA FASO (FORMERLY UPPER VOLTA) USE COUNTRY CODE IF MAKE CAN NOT BE DETERMINED
BR - BURMA USE COUNTRY CODE IF MAKE CAN NOT BE DETERMINED
BFL - BURNET FLAG FIREARMS,LLC CONROE,TEXAS
ED - BURNS PAIUTE TRIBE OF THE BURNS PAIUTE INDIAN COLONY OF OREGON USE THE COUNTRY CODE IF THE MAKE CAN NOT BE DETERMINED
BND - BURNSIDESMFR. OF CIVIL WAR CARBINES
BI - BURUNDI USE COUNTRY CODE IF MAKE CAN NOT BE DETERMINED
BUS - BUSCHER STROTMODELL
BHT - BUSHMASTER MFG BY GWINN FIREARMS
BKI - BUSHNELL HOLDINGS, INC. (BLACKHAWK!) OVERLAND PARK, KANSAS
BIZ - BUSINESS END CUSTOMS, LLC PEABODY, MASSACHUSETTS
BUU - BUSSU
BUT - BUTTERFIELD, JESSE S.
BHG - BUYUK HUGLU TURKEY NOT SAME AS MAK/HUG-HUGLU COOPERATIVE
BWE - BWE FIREARMS LONGWOOD, FLORIDA
CZU - C Z U.S.A.; KANSAS CITY, KS
HEE - C. E. HEINZELMANN HANDGUNS
HAL - C. G. HAENELSAME AS HAENEL-SCHMEISSER
CH - C. H. OR CHIHUAHUA USE COUNTRY CODE IF MAKE CAN NOT BE DETERMINED
CRY - C. RAY SYSTEMS, INC DEERPARK, TEXAS
SHC - C. S. SHATTUCK ARMS CO.
SHA - C. SHARPS & CO. (SHARPS & SONS)
CSH - C. SHARPS ARMS CO., INC. BIG TIMBER, MONTANA; REPLICAS. *NOT SAME AS C. SHARPS & CO. SHARPS & SONS; MAK/SHA)**
FCW - C. W. FRANKLINIMPORTED BY H & D FOLSOM
CML - C0NTINENTAL MACHINE T00L C0, INC; NEW BRIT0N, CT _
CTT - C2 TACTICAL, LLC TEMPE, ARIZONA
CDI - C3 DEFENSE, INC HIRAM, GEORGIA FFL 1-58-223-07-1D-04628 PER ATF
CAS - CA-SI
CBT - CABOT GUN COMPANY, LLC; SARVER, PENNSYLVANIA
XD - CADDO TRIBE OF OKLAHOMA USE COUNTRY CODE IF MAKE CANNOT BE DETERMINED
CGI - CAESAR GUERINI; BRESCIA, ITALY
CAF - CAFELDMFR. OF CANE GUNS
JJA - CALIBER ACQUISITIONS DBA J&J ARMORY AND TACTICAL SUPPLY SANTA ANA, CA
CAL - CALIFORNIA ARMS
CA - CALIFORNIA USE COUNTRY CODE IF MAKE CAN NOT BE DETERMINED
CAE - CALVERT, JOHN
CWC - CALWESTCO INC.IRWIN, CA
CJ - CAMBODIA (FORMERLY KHMER REPUBLIC & KAMPUCHEA) USE COUNTRY CODE IF MAKE CAN NOT BE DETERMINED
CM - CAMEROON USE COUNTRY CODE IF MAKE CAN NOT BE DETERMINED
CPC - CAMP CREEK GUNWORKS COLLEGE PARK, GEORGIA
CE - CAMPECHE USE COUNTRY CODE IF MAKE CAN NOT BE DETERMINED
ARR - CAMPEON/CAMPEON PATENT MODEL OF HIJOS DE C.ARRIZABALAGA
CAG - CAMPO GIRO MADE BY ASTRA
CD - CANADA (SEE DEPARATE LIST OF CANADIAN PROVINCES; USE CODE CD ONLY WHEN PROVINCE IS UNKNOW) USE COUNTRY CODE WHEN MAKE CAN NOT
CIL - CANADIAN INDUSTRIES, LTD. (C.I.L.)USE CIL ONLY WHEN MODEL IS OTHERTHAN LISTED
CZ - CANAL ZONE USE COUNTRY CODE IF MAKE CAN NOT BE DETERMINED
ZI - CANARY ISLANDS USE COUNTRY CODE IF MAKE CANNOT BE DETERMINED
CNK - CANIK55; SAMSUM, TURKEY
CLK - CANNON BLOCKMODEL MFD. BY CLERKE
CCA - CAOL CREEK ARMORY; KNOXVILLE, TENNESSEE
PCE - CAP-CHURE MFG BY PALMER CHEMICAL AND EQUIP-MENT CO., INC., DOUGLASVILLE, GA
CV - CAPE VERDE ISLANDS USE COUNTRY CODE IF MAKE CAN NOT BE DETERMINED
CA0 - CAPITAL ARMAMENT CO. LLC (CAP ARMS) SIBLEY, IA
CAP - CAPITAN
CRC - CARACAL INTERNATIONAL, LLC; ABU DHABAI, UNITED ARAB EMIRATES
CCS - CARACAL USA, LLC NEWINGTON, NEW HAMPSHIRE
HH - CARBOJET MODEL OF HY HUNTER
CAA - CARCANO ITALIAN MILITARY RIFLES
TAP - CARIBOU RIFLE-MODEL OF TAMPEREEN
GCL - CARL GUSTAVSEE FFV
CTL - CARLO CASSARTELLI BRESCIA,ITALY MFR.OF SHOTGUNS
CRV - CARLO RIVA
CAR - CAROLINA ARMS CO.TRADE NAME OF H & D FOLSOM AND SMITH WODSWORTH NAME OF CRESCENT-DAVIS
CRP - CAROLINA ARMS GROUP, LLC MOORESVILLE, NC
CMA - CAROLINA MOUNTAIN TACTICAL WAYNESVILLE, NORTH CAROLINA
CLP - CAROLINA PRECISION FIREARMS, LLC (CPF) ROCKY MOUNT, NC
CG - CAROLINE ISLANDS USE COUNTRY CODE IF MAKE CAN NOT BE DETERMINED
CYA - CARRERO Y ASTELARRA; SPAIN
CAD - CASCADE ARM; TERRE HAUTE , IN
CDE - CASCADE ARMS; MAUPIN, OR
CEI - CASON ENGINEERING INC EL DORADO HILLS, CALIFORNIA
CSC - CASPIAN ARMS LTD.HARDWICK, VT
CSL - CASUAL ARMS CORP. AFTON, WY
CAN - CATABRIA
VP - CATAWBA INDIAN NATION, SOUTH CAROLINA (AKA CATAWBA TRIBE OF SOUTH CAROLINA USE COUNTRY CODE IF MAKE CANNOT BE DETERMINED
CAT - CATCONAPA,CA
CAU - CAUCELEGUI MFG OF HANDGUNS
CAV - CAVALRY ARMS C0RP.; MESA ARIZ0NA
CVR - CAVER SINGLE-SHOT PISTOLS
CVM - CAVIM, VENEZUELA
CP - CAYMAN ISLANDS (DEPENDENT TERRITORY OF UNITED KINGDOM) USE COUNTRY CODE IF MAKE CAN NOT BE DETERMINED)
EF - CAYUGA NATION OF NEW YORK USE COUNTRY CODE IF MAKE CAN NOT BE DETERMINED
CBC - CBC (CIA BRAZILERIA DE CARTUCHOS)
CBI - CBC INDUSTRIES, INC. NORTH CHARLESTON, SC
CCF - CCF RACE FRAMES, LLC; RICHMOND, VIRGINIA
CVD - CDA OF FL,LLC (CIVIL DEFENSE ARMORY) SAINT CLOUD, FL
CDM - CDM (CRITERION DIE & MACHINE CO.)MFR. OF HANDGUNS
GUB - CEDAR THREE ENTERPRISES, INC. (GUN BOSS ARMORY) REDLANDS, CA
CKS - CELIK SILAH SANAYI TURKEY
CEL - CELTA
CEE - CENTAURE (FABRIQUE D' ARMES UNIES DE LIEGE)
CTA - CENTENNIAL ARMS IMPORTER ONLY
CW - CENTRAL AFTICAN REPUBLIC USE COUNTRY CODE IF MAKE CAN NOT BE DETERMINED
CFF - CENTRAL FLORIDA FIREARMS, LLC (LIVE FREE ARMORY) SAINT CLOUD, FL
CKA - CENTRAL KENTUCKY ARMS
CWA - CENTRAL WISCONSIN ARMORY; ELAND, WISCONSIN
CTU - CENTURION ARMS; LLC MORGANTOWN, INDIANA
LAR - CENTURIAN MFR BY LAURONA
CNT - CENTURION TACTICAL LLC TALLAHASSEE, FL.
CAI - CENTURY ARMS INC.ST. ALBANS, VT & BOCA RATON, FLG/PRIMARILY IMPORTER
CIA - CENTURY INTERNATIONAL ARMS, INC.ST. ALBANS, VT; IMPORTER FOR BRNO,FEG, FAMAS, AND NORINCO
CMF - CENTURY MANUFACTURING, INC.GREENFIELD, IN
CTY - CENTURY MFG OF REVOLVERS
ITH - CENTURY SHOTGUN MODEL OF ITHACA
CFR - CEPHYR BRAND NAME OF STOEGER
CES - CESAR UNKNOWN MFR
F0Z - CESKA ZBROJOVKAMFR. OF FOX
CET - CETMESEE ALSO HECKLER & KOCH
CFS - CFS GUNS, TURKEY; MFG SOME OF CHARLES DALY BRAND GUNS FOR KBI, INC.
CF - CHAD USE COUNTRY CODE IF MAKE CAN NOT BE DETERMINED
CMC - CHALLENGER MFG. CO.
CCL - CHAMBERS CUSTOM, LLC CRETE, NEBRASKA
CHT - CHAMELOT TYPE IMPORTED FROM ITALY
CPP - CHAMPION PRECISION FIREARMS, LLC TEMPE, ARIZONA
CFI - CHAMPLIN FIREARMS INC.MFR. OF DELUXE RIFLES
CPN - CHAMPLIN/CHAMPLIN-HASDINS MFR OF RIFLES
CHN - CHAN CHAN
CHC - CHANTECLER
CGZ - CHAOS GEAR SUPPLY RIFLES (CGS RIFLES, LLC) ARTESIA, NEW MEXICO
CPA - CHAPARRAL ARMS, ITALY
CHS - CHAPUIS FRANCE
CC0 - CHARCO; SHELTON, CT WAS SUCCESSOR TO CHARTER ARMS
CHD - CHARLES DALYBRAND OF SHOTGUN
CHE - CHARLES LANCASTER & CO.MULTI BARRELED PISTOLS
SRC - CHARLES STEEN ARMAMENT CO. (SARCO)IMPORTER
CHU - CHAROLA-ANITUA BERGMANN COPY
CTR - CHARTER 2000; HUNTINGTON, CT,DO NOT CONFUSE WITH CHARTER ARMS
CAC - CHARTER ARMS CORPORATION
CHA - CHATELLERAULT
CLL - CHATHAM ARMS, LLC PITTSBORO, NORTH CAROLINA
CGW - CHATTAHOOCHEE GUN WORKS, LLC PHENIX CITY, ALABAMA
BID - CHAZKAT LLC DBA BOLD IDEAS BRECKENRIDGE, TX
CLG - CHEELY CUSTOM GUNWORKS,LLC HOWELL,MI
CHK - CHEROKEE ARMS CO.TRADE NAME OF H & D FOLSOM
CKE - CHEROKEE FIREARMS, LLC SPRINGFIELD, MISSOURI
XE - CHEROKEE NATION OF OKLAHOMA USE COUNTRY CODE IF MAKE CANNOT BEDETERMINED
CFG - CHERRY'S FINE GUNS; GREENSB0R0, NC;
CTD - CHESTERFIELD ARMAMENT CHESTERFIELD, VA
DA - CHEYENNE & ARAPAHO TRIBES OF OKLAHOMA USE COUNTRY CODE IF MAKE CAN NOT BE DETERMINED
CHY - CHEYENNE BRAND NAME OF AMERICAN INPORT CO AND OTHERS
EG - CHEYENNE RIVER SIOUX TRIBE OF THE CHEYENNE RIVER RESERVATION, SOUTH DAKOTA USE COUNTRY CODE IF MAKE CAN NOT BE DETERMINED
CYT - CHEYTAC LLC, ARCO, IDAHO
CI - CHIAPAS USE COUNTRY CODE IF MAKE CAN NOT BE DETERMINED
CPF - CHIAPPA FIREARMS, LTD., DAYTON, OHIO
CHB - CHICAGO
CH0 - CHICAGO ARMS CO.
CHR - CHICAGO DERRINGER CORP.
CHF - CHICAGO FIREARMS, INC.MFR.OF DERRINGERS
HIB - CHICAGO LONG RANGE WONDER BRAND NMAE OF HIBBARD, SPENCER AND BARTLETT
EH - CHICKASAW NATION, OKLAHOMA USE COUNTRY CODE IF MAKE CAN NOT BE DETERMINED
RC - CHICOMABBREVIATION FOR CHINESE COMMUNIST OR PEOPLE'S REPUBLIC OF CHINA USE COUNTRY CODE IF MAKE CAN NOT BE DETERMINED
HAW - CHIEF MARSHAL MFD BY HAWES/SAUER
CHG - CHILDERS GUNS, LLC; FAIRMONT, WEST VIRGINIA
CQ - CHILE USE COUNTRY CODE IF MAKE CAN NOT BE DETERMINED
CHM - CHIMERE REINOIR
CJA - CHINA JINGAN EQUIPMENT; BEIJING, CHINA
CPK - CHIPMUNK MFG. CO.MEDFORD, OR
EI - CHIPPEWA-CREE INDIANS OF THE ROCKY BOY'S RESERVATION MONTANA USE COUNTRY CODE IF MAKE CAN NOT BE DETERMINED
EJ - CHITIMACHA TRIBE OF LOUISIANA USE COUNTRY CODE IF MAKE CAN NOT BE DETERMINED
CHJ - CHONGQING JIANSHE INDUSTRY (GROUP) CO., LTD
CJM - CHOPITEA JOSE MARIA
CHI - CHRISTENSEN ARMS; FAYETTE, UT
CHL - CHURCHILL, E. J., LTD.
CHW - CHYLEWSKI
CIE - CIENER, JONATHAN ARTHUR MFR OF MACHINE GUNS AND SILENCERS
CIF - CIFSAN; TURKEY (LEADING SHOTGUN MANUFACTURER) MARKETING COMPANY / PAZ.TIC.LTD. STI
CIM - CIMARRON ARMS
DW - CITIZEN POTAWATOMI TRIBE OF OKLAHOMA USE COUNTRY CODE IF MAKE CAN NOT BE DETERMINED
J0E - CITIZENS ACADEMY, LLC (JOE FIREARMS) SANDY, UTAH
CTZ - CITIZENS ARMORY (RALEIGH, DE) MEXICO, MISSOURI
CFA - CIVILIAN FORCE ARMS, INC. YORKVILLE, ILLINOIS
CKM - CK ARMS AKA FREEDOM GUN WORKS INC.CAMILLA, GA
CLA - CLABROUGH & SONS
CLI - CLAIR
CLD - CLARIDGE HI-TECNORTH RIDGE, CA
CCG - CLARK CUSTOM GUNS, INC; PRINCETON, LOUISIANA
CLS - CLASSIC ARMSMFR. OF REPLICAS
CDB - CLASSIC DOUBLES INC. JAPAN
CDL - CLASSIC DOUBLES; KODENSHA,TOCHIGI CITY JAPAN; MADE IN JAPAN AND IMPORTED
CMZ - CLASSIC METAL FINISHING, INC. (CMF) JACKSON, MICHIGAN
CIP - CLASSIC PISTOL, INC; SOUTHHAMPTON, PENNSYLVANIA
ZEP - CLAYBIRDER MODEL OF ZEPHYR
NCI - CLAYCO SEE NORTH CHINA INDUSTRIES
CLE - CLEMENT
CMT - CLEMENT-NEUMANN SEMIAUTOMATIC CARBINES
CLV - CLEVELAND ARMS CO.
CLC - CLIC-CLAC REVOLVER -MODEL
CLM - CLIMAX
DB - CLIPPERTON ISLAND (FRENCH POSSESSION) USE COUNTRY CODE IF MAKE CAN NOT BE DETERMINED
CQT - CLOSE QUARTERS TACTICAL, MI
CMM - CMMG,INC. FAYETTE, MISS0URI
CSE - CMS ENGINE SERVICE MARYSVILLE CA
CCW - CNC WARRIOR, LLC-CHARLOTTE, NORTH CAROLINA
CVG - COACHELLA VALLEY GUNS & TACKLE PALM DESERT, CALIFORNIA
CU - COAHUILA USE COUNTRY CODE IF MAKE CAN NOT BE DETERMINED
C0 - COAST-TO-COAST STORES OR COLORADO USE COUNTRY CODE IF MAKE CAN NOT BE DETERMINED
CSG - COASTAL GUN; KINGSLAND, GA
TCE - COBB CONSULTING GROUP, LLC (TACTICAL EDGE ARMS) ARLINGTON,WASHINGTON
CBB - COBB MANUFACTURING; DALLAS, GEORGIA
C0B - COBOLT
CBR - COBRA ENTERPRISES; SALT LAKE CITY, UTAH
C0A - COBRA SEMI-AUTOMATIC PISTOLS
CBA - COBRA TACTICAL, INC. VALENCIA, CALIFORNIA
CBY - COBRAY FIREARMS OF TENNESSEE, LLC (CFT, LLC) DUCKTOWN, TN
SWD - COBRAY FIREARMS SMYRNA, GA
C0C - COCKERILL
EP - COCOPAH TRIBE OF ARIZONA USE COUNTRY CODE IF MAKE CAN NOT BE DETERMINED
DD - COCOS (KEELING) ISLANDS, TERRITORY OF (AUSTRALIAN TERRITORY) USE COUNTRY CODE IF MAKE CAN NOT BE DETERMINED
CRF - CODE RED FIREARMS HIALEAH, FL
C0D - CODY MFG. CORP.
EQ - COEUR D'ALENE TRIBE OF THE COEUR D'ALENE RESERVATION, IDAHO USE COUNTRY CODE IF MAKE CAN NOT BE DETERMINED
C0G - COGSWELL & HARRISON
CEM - COHARIE ARMS, MESA, ARIZONA
CDS - COLE DISTRIBUTING INC. SCOTTSVILLE, KY
C0I - COLIAT
CL - COLIMA USE COUNTRY CODE IF MAKE CAN NOT BE DETERMINED
C0L - COLLATH
CLR - COLLIER RIFLES, LLC MILLEN, GEORGIA
CB - COLOMBIA FUERZAS MILITARES MILITARY WEAPON OF COLUMBIA REPUBLIC USE COUNTRY ID MAKE CANNOT BE DETERMINED
C0N - COLONIAL SPANISH MFG OF ECHHEVERIA
EV - COLORADO RIVER INDIAN TRIBE OF THE COLORADO RIVER INDIAN RESERVATION, ARIZONA AND CALIFORNIA USE COUNTRY CODE IF MAKE CAN NOT
HRR - HENRY REPEATING RIFLE(REPEATING ARMS),NY(COLT BLACK POWDER CO)
CLT - COLT FIREARMS (ACE MODEL)
C0F - COLTON FIREARMS CO.MFR. OF SHOTGUNS FOR SEARS
DP - COMANCHE NATION OF OKLAHOMA USE COUNTRY CODE IF MAKE CAN NOT BE DETERMINED
CMH - COMANCHE, ARGENTINA, NOT SAME AS COMPANY FROM SPAIN
CPR - COMBAT PRECISION TECHNOLOGIES, LLC CUMMING, GEORGIA
CSX - COMBAT SHOOTERS, LLC CLARKSVILLE, TN
CTS - COMBINED TACTICAL SYSTEMS; JAMESTOWN, PENNSYLVANIA (FLASHBANG DEVICES)
CGR - COMGRAF,LLC GUILFORD,CONNECTICUT
LLA - COMMANCHE MODEL OF LLAMA
MPC - COMMANDER MFG BY MEISKA PRODUCTS CO.NOT ASSOCIATED WITH COLT
V0L - COMMANDO MK III SEMIAUTOMATIC CARBINES, SEE VOLUNTEER ENTERPRISES
CPI - COMMERCIAL PRODUCTS
DG - COMOROS, FEDERAL ISLAMIC REPUBLIC OF THE USE COUNTRY CODE IF MAKE CAN NOT BE DETERMINED
CPL - COMPASS LAKE ENGINEERING; ALFORD, FL
MEU - COMPETITION BRAND NAME OF JOHN MENUIER GUN CO
CCI - COMPETITOR CORPORATION INC.GROTON, MA; MANUFACTURES THECOMPETITOR-ROTARY ACTIONSINGLE-SHOT PISTOL.
CPT - COMPONENT METAL PRODUCTS ATLANTA GA
VQ - CONFEDERATED SALISH AND KOOTENAI TRIBES OF THE FLATHEAD RESERVATION, MONTANA USE COUNTRY CODE IF MAKE CAN NOT BE DETERMINED
VX - CONFEDERATED TRIBES AND BANDS OF THE YAKAMA NATION, WASHINGTON USE COUNTRY CODE IF MAKE CAN NOT BE DETERMINED
VW - CONFEDERATED TRIBES OF SILETZ INDIANS OF OREGON (PREVIOUSLY LISTED AS THE CONFEDERATED TRIBES OF THE SILETZ RESERVATION) USE 
EW - CONFEDERATED TRIBES OF THE CHEHALIS RESERVATION, WASHINGTON USE COUNTRY CODE IF MAKE CAN NOT BE DETERMINED
EX - CONFEDERATED TRIBES OF THE COLVILLE RESERVATION, WASHINGTON USE COUNTRY CODE IF MAKE CAN NOT BE DETERMINED
VR - CONFEDERATED TRIBES OF THE COOS, LOWER UMPQUA AND SIUSLAW INDIANS OF OREGON USE COUNTRY CODE IF MAKE CAN NOT BE DETERMINED
FB - CONFEDERATED TRIBES OF THE GOSHUTE RESERVATION, NEVADA AND UTAH USE COUNTRY CODE IF MAKE CAN NOT BE DETERMINED
VU - CONFEDERATED TRIBES OF THE GRAND RONDE COMMUNITY OF OREGON USE COUNTRY CODE IF MAKE CAN NOT BE DETERMINED
FE - CONFEDERATED TRIBES OF THE UMATILLA RESERVATION, OREGON USE COUNTRY CODE IF MAKE CAN NOT BE DETERMINED
FF - CONFEDERATED TRIBES OF THE WARM SPRINGS RESERVATION OF OREGON USE COUNTRY CODE IF MAKE CAN NOT BE DETERMINED
CSM - CONNECTICUT SHOTGUN MANUFACTURING COMPANY, HARTFORD, CONNECTICUT
CT - CONNECTICUT USE COUNTRY CODE IF MAKE CAN NOT BE DETERMINED
CVA - CONNECTICUT VALLEY ARMS
CVC - CONNECTICUT VALLEY CLASSIC INC
C0S - CONSTABLER
CTI - CONSTANTINE ARMORY, LLC SPOKANE, WASHINGTON
THM - CONTENDER MFD BY THOMPSON CENTER
C00 - CONTINENTAL
C0Q - CONTINENTAL ARMS CO.
CWL - CONTINENTAL WEAPONS LTD
GW - CONTINENTAL, THEBRAND OF GREAT WESTERN
CCR - CONTROLLED CHAOS ARMS, LLC BAXTER, IOWA
CQS - CONQUEST, LLC (CONQUEST ARMS) FLORENCE, ARIZONA
C0V - COOEY
DI - COOK ISLANDS USE COUNTRY CODE IF MAKE CAN NOT BE DETERMINED
CMS - COOKSEY MACHINE SHOP
CSP - COONAN ARMSST. PAUL, MN MFR COONAN STAINLESS
CNI - COONAN INC. BLAINE, MN
C0P - COOPER FIREARMS MFG. CO.
CNC - COP, INC.
WC - COQUILLE TRIBE OF OREGON USE COUNTRY CODE IF MAKE CAN NOT BE DETERMINED
DJ - CORAL SEA ISLANDS, TERRITORY OF (AUSTRALIAN EXTERNAL TERRITORY) USE COUNTRY CODE IF MAKE CAN NOT BE DETERMINED
ZAR - CORLAMODEL OF ZARAGOZA
CCE - CORMAC ENTERPRISES, LLC BEAUFORT, SOUTH CAROLINA
CD0 - CORONADO ARMS, INC. DIXON, CA
C0T - CORRIENTES
UNI - CORSAIR MODEL OF UNIQUE
C0Z - CORZO
MZW - COS SEE MERZ WERKE
CR - COSTA RICA USE COUNTRY CODE IF MAKE CAN NOT BE DETERMINED
IY - COTE D'LVOIRE,REPUBLIC OF (IVORY COAST) USE COUNTRY CODE IF MAKE CAN NOT BE DETERMINED
CTC - COTTER & COMPANY USE CTC ONLY WHEN MODEL IS OTHER THAN LISTED
CMR - COUGAR ARMSLONG GUNS
C0X - COUNET
CBS - COUNTRY BOY ENTERPRISESM INC.(COUNTRY BOY SPORTS); HOMER, GEORGIA
CWS - COUNTRY WIDE SPORTS, INC (COLD WAR SHOOTERS) EL PASO, TX
FH - COUSHATTA TRIBE OF LOUISIANA USE COUNTRY CODE IF MAKE CAN NOT BE DETERMINED
CMG - COVERT ARMS MFG. COMPANYEL PASO, TX
C0Y - COW BOY RANGERBRAND OF ROGERS & SPENCER
C0W - COW BOY UNKNOWN MFR
WH - COW CREEK BAND OF UMPQUA INDIANS OF OREGON USE COUNTRY CODE IF MAKE CAN NOT BE DETERMINED
WJ - COWLITZ INDIAN TRIBE, WASHINGTON USE COUNTRY CODE IF MAKE CAN NOT BE DETERMINED
CBM - CRABIL MANUFACTURING, INC. ST. PETERSBURG, FL
CRT - CRAFT PRODUCT CO.MFR. OF HANDGUNS
CRA - CRAIG
CKW - CRAIG KLINTWORTH GUN & RIFLE MANUFACTURERS LTD. JOHANNESBURG,SOUTH AFRICA
CTM - CREATIVE ARMS, LLC DES MOINES,IOWA
BTD - CREC INVESTMENTS INC. AKA BELTFED CHINO, CA
CRM - CRESTWOOD ARMS
CWF - CRIMSON WOLF ARMORY, LLC FLINT, TEXAS
CRI - CRIOLLA
CMN - CRITICAL ARMAMENT, LLC CHINO VALLEY, ARIZONA
CCP - CRITICAL CAPABILITIES, LLC FAYETTEVILLE, NC
KC - CROATIA USE COUNTRY CODES IF MAKE CAN NOT BE DETERMINED
CR0 - CROSMAN ARMS CO.MFR. OF AIR GUNS
CST - CROSS MACHINE TOOL CO. INC. AKA CMT LEXINGTON, TN
CXB - CROSSBONES ENTERPRISES, LLC BENTONVILLE, ARKANSAS
CSS - CROSSFIRE
CSF - CROSSFIRE LLC LAGRANGE GA
CTH - CROSSHILL TECHNOLOGIES LLC DBA CROSSHILL TECH / CROSSHILL ARMS SANDY, UT
FK - CROW CREEK SIOUX TRIBE OF THE CROW CREEK RESERVATION, SOUTH DAKOTA USE COUNTRY CODE IF MAKE CAN NOT BE DETERMINED
FM - CROW TRIBE OF MONTANA USE COUNTRY CODE IF MAKE CAN NOT BE DETERMINED
CRW - CROWN CITY ARMS
CRG - CRUCELEGUI
CRU - CRUCERO
CSD - CRUSADER ARMS COMPANY
CUS - CRUSADER OPERATOR CORPORATION POWELL BUTTE, OR
CSA - CSC ARMS,LLC DAVIE, FLORIDA
ZR0 - CSJB HOLDINGS,INC. (ZRODELTA) LUBBOCK,TEXAS
CC - CUBA, REPUBLIC OF USE COUNTRY IF MAKE CAN NOT BE DETERMINED
CNM - CUNO MELCHER
CCU - CURTIS CUSTOM, LLC ALAVARADO, TX
CUT - CUSTOM ARMS & ACCESSORIES, LLC ASHLAND, KENTUCKY
CDF - CUSTOM DEFENSE FIREARMS, LLC KILLEEN, TX
CGS - CUSTOM GUN SOLUTIONS, LLC. GREENWOOD, NEBRASKA
ZAN - CUSTOM MODEL SHOTGUN MODEL OF ZANOTTI
NVA - CUTLASS (GUN KIT)BRAND NAME USED BY NAVY ARMS CO.
CYS - CYLINDER & SLIDE INC., FREEMONT, NB
CS - CYPRUS,REPUBLIC OF USE COUNTRY CODE IF MAKE CAN NOT BE DETERMINED
CGT - CZ GUNS TRADE ( NOT TO BE CONFUSED WITH CESKA ZBROJOVKA) ALSO KNOWN AS ARMS MORAVIA
CZR - CZAR MODEL OF HARRINGTON & RICHARDSON HOOD FIREARMS CO,AND HOPKINS & ALLEN
EZ - CZECH REPUBLIC USE COUNTRY CODE IF MAKE CAN NOT BE DETERMINED
CZK - CZECH SMALL ARMS JABLUNKA, CZECH REPUBLIC
DLS - D & L SPORTS, INC., GILLETTE, WYOMING
DXI - D MAX, INC ; SPRINGFIELD, SOUTH DAKOTA NOT SAME AS D-MAX COMPANY; OCEAN SHORES WASHINGTON / TRADE NAME -ULTRATEC INC
DDS - D&D SALES AND MANUFACTURING SIERRA VISTA, AZ
D0D - D'ORDNANCE
DMX - D-MAX COMPANY AUBURN / OCEAN SHORES WASHINGTON-ULTRATEC INC
DSL - D-SQUARED INDUSTRIES, LLC (GIDEON ARMAMENT) CASTLE ROCK CO
DTK - D-TECHNIK, CZECH REPUBLIC; AK STYLE RIFLES
FAI - D. G. F. M.MFD. BY F. M. A. P.(FABRICA MILITAR DE ARMAS PORTATLES)(AKA-FM) *** COMPANY CHANGED NAME TO: FABRICA MILITAR FRAY
DMW - D. M. W.
DBS - D0UBLE STAR C0RP., WINCHESTER, KENTUCKY
DCR - DACIN, ROGER
DDF - DAEMON DEFENSE, LLC CHATHAM, NEW HAMPSHIRE
DW0 - DAEWOO MFG IN KOREA & IMPORTED TO THE US BY STOEGER INDUSTRIESINC.HACKENSACK, NEW JERSEY
DAH - DAHMER ARMS, LLC ANNA, ILLINOIS
DAI - DAISY (HEDDON) MFR OF RIFLES AND AIR GUNS
DIW - DAIWA
DAA - DAKIN IMPORTER,ALSO SEE UNION ARMERA OF SPAIN
DKA - DAKOTA ARMS STURGIS,SD; MFR. SINGLE-SHOT RIFLES BASED ON 19TH CENTURY DESIGNS
DAK - DAKOTA IMPORTED BY EMF CO.,INTERARMCO,AND SALFORD IMPORTS
DKT - DAKOTA TACTICAL FARMINGTON HILLS, MI
DPH - DAL PHON SA. SHELTON, WA
DAM - DAMAGE INC. LLC, GLOBE, ARIZONA
DMR - DAMAR TWO BARREL PISTOLS
WE0 - DAN B. WESSON ARMS OUT OF BUSINESS NOW KNOWN AS WESSON FIREARMS CO., INC
DCI - DAN C00NAN INDUSTRIES; ALSO KNOWN AS DC INDUSTRIES; BLOOMINGTON, MINNESOTA
DAC - DANCE BROS. & PARK
DNA - DANE ARMORY, LLC-MESA ARIZONA
DDI - DANIEL DEFENSE INC SAVANNAH, GEORGIA
DFC - DANL. FRASER & COMPANY; EDINBURGH, SCOTLAND
D0K - DANOK
DAY - DANSK REKYLRIFFEL SYNDIKAT
GE - DANZIGROYAL ARSENAL OR GERMANY USE COUNTRY CODE IF MAKE CAN NOT BE DETERMINED
DAP - DARDICK CORP.MFR. OF PISTOLS
DAL - DAREDEVIL DISTRIBUTED BY EPPINGER GUN CO
DRR - DAREINGARMS, LLC VALLEY VIEW, TEXAS
DRK - DARK STORM INDUSTRIES, LLC EAST ISLIP, NY
DKE - DARKON ENTERPRISES, LLC BUNNELL,FLORIDA
DAR - DARLING (B. OR B. M.)
DRA - DARRA; PAKISTAN
DSN - DASAN USA, INC.(LITHGOW ARMS USA,ALPHA FOXTROT) DULUTH,GEORGIA
DAU - DAUDETEAU, L.MILITARY WEAPONS
DUD - DAUDSONS ARMOURY, PAKISTAN
DVL - DAVALON MFR OF SHOTGUNS
DV0 - DAVIDSON FIREARMS CO.IMPORTER
DAD - DAVIS ARMSMFRS. DAVIS MARTIN
DAX - DAVIS GUNS BRAND NAME USED BY CRESCENT;DAVIS-WARNER, AND N. R. DAVIS & SONS
DAB - DAVIS INDUSTRIES CHINO, CA
DNR - DAVIS, N. R., & SONS MFR OF SHOTGUNS
DAW - DAVIS-WARNER ARMS CORP.
DWD - DAWN OF DEFENSE, LLC (DOD) FORT OGLETHORPE, GEORGIA
DWP - DAWS0N PRECISI0N; LEANDER,TEXAS
DYT - DAYTAC AKA DAYTONA DEFENSE & TACTICAL HOLLY HILL, FLORIDA
PIC - DECATUR IMPORTER OF PRECISE IMPORTS C0
DEC - DECKER
DEI - DECORTIS, G.
DCL - DEE CONSULTING CO. LLC WHITTIER, CA
DRC - DEEP RIVER CUSTOMS,INC. RAMSEUR, NC
DRX - DEER COUNTRY ARCHERY, INC. (DCA, INC., RED X ARMS) STARBUCK, MINNESOTA
DEE - DEFENDER (HANDGUN)MFD. IN U.S. BY IVER JOHNSON
DEB - DEFENSE
DPM - DEFENSE PROCUREMENT MANUFACTURING SERVICES,INC.BECKER, MN DOESBUSINESS AS DPMSINC.(PANTHER ARMS)
DRD - DEFENSE RESEARCH & DEVELOPMENT, LLC DBA DRD DALLAS, GA
DTC - DEFENSE TECHN0L0GY C0RP.; CHEYENNE. WY0MING
DFS - DEFENSIVE CREATIONS, LLC ALLIANCE, OH
DF0 - DEFENSOR ORDNANCE,LLC SAINT CHARLES, MISSOURI
DFN - DEFIANCE MACHINE INC; COLUMBIA FALLS, MONTANA ADDED/ASSIGNED 7/17/14
DEF - DEFIANCE MFR. INC.
DFA - DEFINITIVE ARMS, LLC ST PETERSBURG, FL
DEG - DEGTYAREV
DEK - DEK-DU
DLN - DEL-TON, INC., ELIZABETHTOWN, NC
DMY - DELAWARE MACHINERY & TOOL; MUNCIE, INDIANA
XF - DELAWARE NATION OF OKLAHOMA (FORMERLY WESTERN DELAWARE TRIBE, OKLAHOMA (XM)) USE COUNTRY CODE IF MAKE CANNOT BE DETERMINED
XQ - DELAWARE TRIBE OF OKLAHOMA USE COUNTRY CODE IF MAKE CANNOT BEDETERMINED
DE - DELAWARE USE COUNTRY CODE IF MAKE CAN NOT BE DETERMINED
DLP - DELPHI TACTICAL, LLC RAEFORD, NORTH CAROLINA
DEL - DELPHIAN ARMS CO.
DLD - DELTA LEVEL DEFENSE, LLC STRATFORD, CT
DTH - DELTA THREE TACTICAL, LLC ADAIRSVILLE,GA
DEM - DELU, FABRICA D'ARMES F.
DEX - DELUXE (PISTOL)
DMA - DEMAIN, INC.IMPORTER ONLY
DE0 - DEMON
DEA - DEMON "MARINE"
DEN - DEMONTANT
DR0 - DEMRO TAC 1DEMRO TAC PRODUCTS, MANCHESTER, CT
DND - DENARD, JOHN C., CO.DISTRIBUTOR OF FIREARMS IN EUROPE
DK - DENMARK, KINGDOM OF USE COUNTRY CODE IF MAKE CAN NOT BE DETERMINED
LUR - DEPUTY, L. A.MODEL OF L. A. FURY
DEH - DERINGER, HENRY, SR. & JR.EARLY MFR. OF PISTOLS AND RIFLES
DER - DERRINGER CORP.
DYA - DERYA SILAH SANAYI AKA DEYRA ARMS TURKEY
ISR - DESERT EAGLE MFD BY ISRAELI MILITARY IND.IMPORTED BY MAGNUM RESEARCH
DFF - DESERT FIREARM FINISHES, LLC (DESERT FIREARMS) PHOENIX, ARIZONA
DII - DESERT INDUSTRIES INCLAS VEGAS,NV
DT0 - DESERT ORDNANCE; CORNVILLE, ARIZONA
DRT - DESERT TACTICAL ARMS; SALT LAKE CITY, UTAH
DTT - DESERT TECH, LLC WEST VALLEY, UT
DSW - DESERT WEAPONRY; TUCSON, ARIZONA
GAZ - DESTROYER (PISTOL)MODEL OF GAZANAGA
DES - DESTROYER/DESTROYER (CARBINE)9MM POLICE CARBINE
DDV - DESTRUCTIVE DEVICES INDUSTRIES (DDI)KNOXVILLE, TENNESSEE
SAR - DESTRUCTOR MODEL OF SALAVERRIA
DET - DETECTIVE BRAND NAME OF VARIOUS MFRS
DDT - DETONICS 0R DETONICS DEFENSE TECH NOT SAME AS DETONICS USA OR OR NEW DETONICS MFG
DTN - DETONICS MFG. OF HANDGUNS
DTS - DETONICS USA; PENDERGRASS, GA (NOT SAME AS DETONICS MANUFACTURING
DEV - DETROIT ARMS CO.
DGW - DETROIT GUN WORKS TROY, MICHIGAN
DEZ - DEUTSCHE TREFF
DWM - DEUTSCHE WAFFEN & MUNITIONSSEE D. W. M.
0RT - DEUTSCHE WERKE (BERLIN)PISTOLS, SEE ORTGIES
DEQ - DEVAULT INDUSTRIES, LLC CANTON, OHIO
DDG - DEVIL DOG ARMS, INC. LAKE ZURICH, ILLINOIS
DL - DEVIL'S LAKE SIOUX TRIBE NORTH DAKOTA NOW SPIRIT LAKE TRIBE NORTH DAKOTA USE COUNTRY CODE IS MAKE CAN NOT BE DETERMINED FOR R
DVN - DEVON ARMORY, LLC-CONNECTICUT
DZZ - DEZ ARMS, INC. ADAMS, WI
DGC - DGC CUSTOM GUNSMITHING; COVINGTON, TENESSEE _(TRADE NAME FOR C.O. ARMS)
MIR - DIAMOND (SHOTGUN)MODEL OF MIROKU
DIA - DIAMOND ARMS CO.
DBK - DIAMONDBACK ARMS, INC., COCOA, FLORIDA
DMD - DIAMONDHEAD USA WEST SPRINGFIELD, MASSACHUSETTS
DIN - DIANAMFR. OF SHOTGUNS
WKN - DIANE (PISTOL)MODEL OF WILKINSON ARMS CO.
DIR - DIARM, S.A.DEBA, SPAIN
DWA - DIAWA
DIS - DICKINSON, E. L.
DKC - DICKSON CAPITAL BRAND OF SHOTGUNS
DI0 - DICKSON TRADE NAME OF VARIOUS MFGRS
DIT - DICTATOR
DM0 - DIEMACO; CANADA
DIK - DIKAR SPANISH MANUFACTURER (CVA-CT. VALLEY ARMS;IMPORTER OF THESE WEAPONS
DTA - DIRECT ACTION CORPORATION; PHOENIX, ARIZONA
DAT - DIRECT ACTION SOLUTIONS, LLC (DAS) SAN DIEGO, CA
DBI - DIRTY BIRD INDUSTRIES; LLC BAKERSFIELD, CALIFORNIA
DSP - DISCOVER BRAND OF SHOTGUNS
DC - DISTRICT OF COLUMBIA USE COUNTRY CODE IF MAKE CAN NOT BE DETERMINED
DF - DISTRITO FEDERAL (MEXICO, D.F.) USE COUNTRY CODE IF MAKE CAN NOT BE DETERMINED
DIV - DIV 3,INC.(DIVISION 3 WEAPONS) ORANGE CITY,FLORIDA
DVA - DIVA ARSENAL, LLC; EVANSVILLE, INDIANA
DJG - DJ GETZ FIREARMS COMPANY; SLATINGTON, PENNSYLVANIA
DN - DJIBOUTI, REPUBLIC OF USE COUNTRY CODE IF MAKE CAN NOT BE DETERMINED
DLK - DLASK ARMS CORP CANADA
DNT - DNA TACTICAL, LLC GOLETA, CA
D0A - DOA RIFLES, LLC SHAWNEE, OKLAHOMA
DTW - DOC'S TACTICAL WEAPONS SUPPLY,LLC (DTWS) HODGES,SC
DKI - DOKI MFR OF SHOTGUNS
DM - DOMINICA USE COUNTRY CODE IF MAKE CAN NOT BE DETERMINED
DR - DOMINICAN REPUBLIC USE COUNTRY CODE IF MAKE CAN NOT BE DETERMINED
D0N - DOMINO.22 TARGET PISTOLS
WAG - DON AUSTIN WAGENKNECHT GRANDVIEW MO
D0M - DORMAN
D0R - DORMUS
DDE - DORNAUS & DIXON ENTERPRISES, INC.HUNTINGTON BEACH, CA
GEC - DORNHEIM, G. C.SEE GECADO. TRADEMARK OF GEORGECARL DORNHEIM
D0S - DOS LEONES
DDA - DOUBLE D ARMORY, LTD GREENWOOD VILLAGE, CO
DDL - DOUBLE DIAMOND LAW ENFORCEMENT SUPPLY COMPANY, LLC TUCSON, ARIZONA
DTP - DOUBLETAP DEFENSE, LLC SAINT LOUIS, MISSOURI
D0U - DOUGLAS
DMS - DPM SHOPS LEXINGTON, KY
DRY - DR GUNS, LLC (DAVID RYBACKI) LAKE ZURICH, ILLINOIS
DRF - DRAGON FIRE ARMORY, LLC WINTER HAVEN, FLORIDA
DRI - DREADNAUGHT INDUSTRIES, VON ARMY, TEXAS
DRE - DREADNOUGHT MFG IN THE U.S. BY HOPKINS & ALLEN
DRU - DREUX
RMM - DREYSE MFD BY RHEINISCHE METALWAREN
DRV - DRULOV
DSA - DSA INC.ROUND LAKE,IL
DSC - DSCHULLNIGG
0RM - DUAN MFG BY ORMACHEA
DBA - DUBIEL ARMS CO.
PC - DUCIE ISLANDS PITCAIRN, HENDERSON, DUCIE AND OENO ISLANDS (DEPENDENT TERRITORY OF UNITED KINGDOM) USE COUNTRY CODE IF MAKE CA
DUK - DUCK CREEK ARMORY, INC. DAVENPORT, IOWA
WM - DUCKWATER SHOSHONE TRIBE OF THE DUCKWATER RESERVATION, NEVADA USE COUNTRY CODE IF MAKE CAN NOT BE DETERMINED
DUC - DUCO BRAND NAME OF DUMOULIN
WAN - DUNLAP SPECIAL (PISTOL)MODEL OF WARNER ARMS CO.
DU0 - DUO
FD0 - DUOMODEL OF F. DUSEK OPOTSCHNO
D0 - DURANGO USE COUNTRY CODE IF MAKE CAN NOT BE DETERMINED
DUT - DUTCH HEMBRUG MADE FOR THE DUTCH MILITARY
DUV - DUVAL & ASSOCIATES, INC. (DUVAL ARMS); MCKINNEY, TEXAS ADDED/ASSIGNED 7/16/15
VCI - DYNAMIC (SHOTGUN)IMPORTED BY VIRGINIA CAPES IMPORTERS
DYM - DYNAMIC MUNITIONS, LLC KATY, TEXAS
DYN - DYNAMITE NOBEL DISTRIBUTOR
EMI - E & R MACHINE, INC.FRAMES ONLY
ELM - E&L MANUFACTURING INC. RIDDLE, OR
ESE - E. A. CO.ESSENTIAL ARMS COMPANY
PRE - E. A. PRESCOTT
ECY - E. A.ECHAVE Y ARIZMENDI ALSO SEE;ECHASA-EIBAR CORRECT CODE SHOULD BE MAK/ECE
REL - E. M. REILLY & CO.
WTY - E. WHITNEY EARLY MFGR OF RIFLES
W0E - E. WOERTHER
EBM - E.A. BROWN MANUFACTURING ALEXANDRIA, MN SINGLESHOT PISTOLS
EMC - E.R. MAPLES COMPANY ANTIOC, TN
ESH - E.R. SHAW, INC. BRIDGEVILLE, PENNSYLVANIA
ERS - E3 ARMS, LLC; LAKE HAVASU CITY, ARIZONA
EEA - EAGLE ARMSCOAL VALLEY, IL
EAA - EAGLE ARMS GENESEO, IL
EAG - EAGLE ARMSIMPORTED BY J. L. GALEF
EEF - EAGLE EYE FIREARMS, INC.BUELLTON, CALIFORNIA
EGL - EAGLE GUN CO.
EAR - EARTHQUAKE BRAND-TRADE NAME USED BY E.L DICKINSON
ECC - EAST COAST CUSTOM TACTICAL,LLC LEESBURG,FL
ECG - EAST COAST GUN SALES, LLC (QORVAL, LLC) ALTOONA, PENNSYLVANIA
EAT - EASTERN ARMS CO.BRAND NAME OF MERIDEN FIREARMS CO.AND STEVENS
FQ - EASTERN BAND OF CHEROKEE INDIANS OF NORTH CAROLINA USE COUNTRY CODE IF MAKE CAN NOT BE DETERMINED
EFC - EASTERN FIREARMS CO.IMPORTER, SEE SHERWOOD
XG - EASTERN SHAWNEE TRIBE OK OKLAHOMA USE COUNTRY CODE IF MAKE CANNOT BE DETERMINED
FT - EASTERN SHOSHONE TRIBE WYOMING USE COUNTRY CODE IF MAKE CAN NOT BE DETERMINED
EAE - EASTERN SPORTS IMPORTER FOR DYNAMITE NOBEL
ETR - EASTERNBRAND NAME OF STEVENS
ECH - ECHO FIREARM REFINISHING AND ARMORY RICHMOND, CA
ENT - ECHO NINE THREE DALLAS, TEXAS
ECL - ECLIPSE
ECP - ECLIPSE SEE E.C. MEACHAM ARMS CO
EU - ECUADOR USE COUNTRY CODE IF MAKE CAN NOT BE DETERMINED
EBP - ED BROWN PRODUCTS INC.
ETY - ED'S TACTICAL ARMORY PLACENTIA, CA
EDC - EDC TACTICAL, LLC RICHMOND, VIRGINIA
EDY - EDDY MFG. CO. (EMC)
EDM - EDM'L ARMS
TRY - EDWARD TRYON & CO.DISTRIBUTOR ONLY
EFF - EFFEBI SNC INC., ITALY FORMERLY KNOWN AS DOCTOR FRANCO BERETTA ALSO AS ARMI EFFEBI
EGI - EG INDUSTRIES,INC. (BULLET GUY) TILLSON, NY
EGE - EGE SILAH (TRI STAR PHANTOM) TURKEY
EY - EGYPT (FORMERLY UNITED ARAB REPUBLC) USE COUNTRY CODE IF MAKE CAN NOT BE DETERMINED
EIG - EIG CUTLERY IMPORTER OF WEAPONS MFD IN ITALY,JAPAN, SPAIN, ANDWEST GERMANY
EIN - EINHAND POCKET PISTOLS
EKS - EKSEN SILAH SAN TIC LTD STI TURKEY
ELC - EL CID
USP - EL DORADO BRAND NAME OF UNITED SPORTING ARMS
ELF - EL FAISAN
ELP - EL PERROMFD. BY LAS CURARIN Y OLASOLA
EL - EL SALVADOR USE COUNTRY CODE IF MAKE CAN NOT BE DETERMINED
ELR - ELBERT MFGR OF CANE GUNS
ELB - ELDERKIN & SONS
ELY - ELECTRIC CITYMFD. BY CRESCENT OR H & D FOLSOM
EEM - ELEMENTAL ARMS, LLC EL CAJON, CALIFORNIA
ELE - ELEY/ELEY-KYNOCH
ELI - ELITE ARMS AND AMMUNITION THOMASVILLE, NORTH CAROLINA
EIR - ELITE IRON LLC, POTOMAC, MT
ETC - ELITE TACTICAL WEAPONS, LLC SHREVEPORT, LOUISIANA
EWA - ELITE WARRIOR ARMAMENT LLC RIO RANCHO, NM
ELK - ELK RIVER TOOL AND DIE, INC (TRADE NAME-ELK RIVER) HOUSTON,TX
EKT - ELKHORN TRAIL RIFLES, LLC COTTAGE GROVE, OREGON
ELL - ELLIOTT
ELS - ELLS, JOSIAHEARLY ARMS MFR.
HA0 - ELOF HANSSON
CPY - ELTISTE STAMP ACQUISITIONS, LLC (CAPITOL ARMORY) CEDAR PARK, TX
PDT - ELTS CONSULTING,LLC (PANDA TACTICAL) LEXINGTON PARK, MARYLAND
FU - ELY SHOSHONE TRIBE OF NEVADA USE THE COUNTRY CODE IF MAKE CAN NOT BE DETERMINED
EMK - EMDEKO INTERNATIONAL
ETI - EMERGING TECHNOLOGIES, INC.LITTLE ROCK, AR; MAKES LASERAIM.
EMF - EMF CO. (EARLY & MODERN FIREARM IMPORTER ONLY)
KER - EMIL KERNER
ZEH - EMIL ZEHNER (SUHL)MFR. OF PISTOLS
EMA - EMPIRE ARMS CO.MADE BY CRESCENT AND HUNTER ARMSFOR SEARS
EAP - EMPIRE ARMS, INC. (EA TACTICAL) GOODYEAR, ARIZONA
ERC - EMPIRE RIFLE CO LLC; MERIDEN, NEW HAMPSHIRE
EMP - EMPIRE STATE ARMS CO.
ECR - ENC0RE
ENC - ENCOM AMERICA
ENI - ENCOM SEE ALSO ENFIELD AMERICA
EEL - ENGAGE ARMAMENT, LLC ROCKVILLE, MD
EN - ENGLAND OR UN FOR UNITED KINGDOM USE COUNTRY CODE IF MAKE CAN NOT BE DETERMINED
ENA - ENTERPRISE ARMS
EGW - ENTERPRISE GUN WORKSMFR. OF SHOTGUNS
EK - EQUATORIA GUINEA USE COUNTRY CODE IF MAKE CAN NOT BE DETERMINED
VAM - ERABRAND OF VALMET
ETT - ERATHR3, LLC GRANTS PASS, OREGON
ER - ERIKA OR EUROPA ISLAND (FRENCH POSSESSION) USE COUNTRY CODE IF MAKE CAN NOT BE DETERMINED
ET - ERITREA USE COUNTRY CODE IF MAKE CAN NOT BE DETERMINED
ERL - ERL SVENDSEN NOW CALLED EAFAC, INC MFR. OF DERRINGERS
ERM - ERMA/ERMA WERKE
KAZ - ERNEST KAZIK MILWAUKEE WI
ETW - ERNST THELMANN WERKE MFR OF GERMAN MAKAROV
ERQ - ERQUIAGA, MARGURUZA, Y CIA
ESC - ESCODIN
ESG - ESG GUNWORKS, LLC; BAYTOWN, TEXAS
ESP - ESPERANZA
ESR - ESPINGARDA
ESX - ESSEX ARMS CORP.FRAMES ONLY
ETA - ESTAL
EEP - ESTEBAN VENTURES, LLC (PRIDE ARMS) ROSHARON, TX
ES - ESTONIA USE COUNTRY CODE IF MAKE CAN NOT BE DETERMINED
ETU - ESTUL, INC.
E0 - ETHIOPIA USE COUNTRY CODE IF MAKE CAN NOT BE DETERMINED
ETN - ETNA
STV - EUGENE STONER DESIGNER OF STONER WEAPONS SYSTEM
EUR - EUROARMS
EUM - EUROMANUFACTURE MFR OF BLACK POWDER GUNS
EAB - EUROPEAN AMERICAN ARMORY CORP.HIALEAH, FL
EAM - EUROPEAN AMERICAN ARMS CORP.
ETL - EUROSTAHL IMPORTER ONLY
EUK - EUSKARO (TRADE NAME USED BY ESPRIN HERMANOS- SPANISH REVOLVER)LOCATED IN EIBAR SPAIN MDG FIREARMS 1906-1917
EDR - EUSTA/EUSTA-SCHIEDER BRAND NAME OF KASCHIE-WRAGE
EGS - EVAN'S GUNSMITHING SHOOTERS WORLD ORANGE, CA
EES - EVANS MACHINING SERVICE, INC. (NITE OWL FIREARMS) CLAIRTON, PA
EVN - EVANS RIFLE MANUFACTURING COMPANY MECHANIC FALLS, MAINE
EVB - EVER BEST SINGLE BARRIL SHOTGUN
EVL - EVOLUTION ARMORY, LLC SOMERSWORTH, NH
EVS - EVOLUTION SPORTS REDLANDS, CA
EWB - EWBANK MANUFACTURING; WINSL0W, ARIZ0NA
EXA - EXCALIBUR SHOTGUNS
EXL - EXCEL INDUSTRIES, INC. CHIN0, CALIF0RNIA _STARTED BUSINESS IN 1997 SAME PREMISES AS ACCU-TEK (OUT OF BISINESS IN 1999) BEGAN
EEI - EXCELL ENTERPRISES INC. DAYTON, TN.
EXC - EXCELSIOR MFG IN U.S. BY BLISS & GOODYEAR
EET - EXECUTIVE ARMAMENT, LLC DALLAS, TEXAS
EXE - EXEL ARMS OF AMERICA
XPR - EXPERT BRAND OF CRESCENT
EXP - EXPERT RIFLE
EXR - EXPRESSREVOLVER MFD. IN U.S. BY BACON
EXZ - EXTAR, LLC LAKE HAVASU CITY, ARIZONA
EXX - EXTREME TACTICAL KALISPELL, MONTANA
FLS - F AND L, SRL
FDD - F&D DEFENSE, LLC SEMINOLE, OKLAHOMA
F0N - F-1 FIREARMS, LLC; SPRING, TEXAS
FB0 - F-BOMB ORDNANCE, LLC ST. CROIX FALLS, WISCONSIN
FEE - F. DA DE ESCOPATOS MFR OF SHOTGUNS
FIP - F. I. E. (FIREARMS IMPORT AND EXPORT) TITAN
LAN - F. L. (F. LANGENHAN)
FPT - F. PEDRETTI BRESCIA, ITALY
FRZ - F.A.I.R., TECNI-MEC, I. RIZZINI ITALY
FMJ - F.M.J.FULL METAL JACKET, COPPERHILL, TN;MFG. .38 AND .45 CALIBER SINGLE-SHOT DERRINGER. ALSO MFRS. .45LONG COLT/410 BORE.
FNM - F.N. MANUFACTURING, INC.; COLUMBIA, SC
FTL - F.T.L. MARKETING
FNE - F1 ENGINEERING (ROGER GERALD FLYNN) HESPERIA,CA
FFD - F4 DEFENSE, LLC LEXINGTON PARK, MD
MAS - FA MASSEE ALSO M. A. S.
FBC - FAB (F. A. BOWER)IMPORTER ONLY
FAA - FAB ARM 0R FABARM; ITALIAN MANUFACTURER
LCB - FABBRICA ARMI LUCIANO BOSIS-ITALY
ZTT - FABIO ZANOTTI MFG OF SHOTGUNS
GRG - FABRICA ARMI GRADOGA MFR OF HANDGUNS
FAS - FABRICA ARMI SAREZZO
FDA - FABRICA D'ARMAS-IWA
TFG - FABRICA D'ARMI F. LLI TANFOGLIO
FFP - FABRICA D'ARMI FRATELLI PIETTA / PIETA, F. LLI OR F.LLI PIETTAITALY
MFA - FABRICA DE ARMAS MEXICO CITY
FMG - FABRICA DE MATERIAL DE GUERRAGOVERNMENT MILITARY ARSENAL
FMP - FABRICA MILITAR DE BRACO DE PRATA (PORTUGAL) ORIG MADE FIREARMS FOR PORTUGESE MILITARY, LATER BECAM PRIVATE COMPANY AND HAS 
FBA - FABRIN0R, ARMA C0RTA Y MICR0FUSI0N SAL; SPAIN
FAB - FABRIQUE D'ARMES DE GUERRE DE
FBM - FACT0RY MILITARY (FABRICACI0NES MILITARES), ARGENTINA; FM HIGHP0WER FIREARMS 0R MILITARES FABRICACI0NES
FAD - FADE
FJW - FAHRZEUG UND JAGDWAFFGN
FAJ - FAJEN MFG. CO.
FAL - FALCON
WLD - FALKE/FALKE WORLD ARMS MFD BY WORLD ARMS CORPORATION
FA - FALKLAND ISLANDS, COLONY OF THE (ISLAS MALVINAS) USE COUNTRY CODE IF MAKE CAN NOT BE DETERMINED
FKR - FALKOR DEFENSE KALISPELL, MT
FBW - FALLING BLOCK WORKS SINGLE SHOT RIFLES,SEE FIX
FSC - FALLING SKIES CORP. BUDA, TEXAS
FAM - FAMARS DI-ABBIATICO & SALVINELLI MFR OF RIFLES AND SHOTGUNS
FMC - FAMCO AKA FLORIDA ARMS MANUFACTURING LAKELAND, FL
FME - FAME
FAR - FAR
Z0L - FARA
F0 - FAROE ISLANDS USE COUNTRY CODE IF MAKE CAN NOT BE DETERMINED
FAW - FARWELL ARMS CO.
FS0 - FAUSTI STEPHANO
FST - FAUSTO MASSI VICENZA, ITALY
FAV - FAVORIT
FFM - FAXON FIREARMS LLC CINCINNATI, OH
FBN - FBN
FET - FEATHER ENTERPRISESBOULDER, COLORADO
MEI - FEDERAL ARMS CO.BRAND OF MERIDIAN
FEC - FEDERAL ENGINEERING CORP.MFR. OF RIFLES
FFC - FEDERAL FIREARMS CO.
FDL - FEDERAL LABORATORIES MFGR OF TEAR GAS GUNS AND AMMUNITION
FE0 - FEDERAL ORDNANCE SOUTH ELMONTE CA
FS - FEDERATED STATES OF MICRONESIA USE COUNTRY CODE IF MAKE CAN NOT BE DETERMINED
FEK - FEEK'S TACTICAL MENDON, MICHIGAN
FEI - FEINWERKBAU MFR OF F12 SPORTER PELLET RIFLE
FEL - FELIA ARMS CO.
SAQ - FELIX SARASQUETA & CO.MFR. OF SHOTGUNS
FLK - FELK INDUSTRIES WARNERS BAY AUSTRALIA
TLR - FELLING-SAUKE CENTER, MN
FED - FERERAL ARMAMENT, LLC (FEDARM); FORT SMITH, ARKANSAS _ADDED/ASSIGNED 10/28/15
FEF - FERFRANS, INC-MONTCLAIR, CALIFORNIA
FEH - FERLACHMFR. OF SHOTGUNS AND RIFLES. ALSOCITY IN AUSTRIA
FER - FERNWOOD GUN SUPPLY MFR OF PERCUSSION KITS
FRR - FERRETBRAND OF UNIVERSAL SALES
FEU - FERUNION
FFV - FFV (FORENADE FABRIK VERKEN)IMPORTER AND EXPORTER OF HUSQVARNAAND CARL GUSTAV
FI - FIALA ARMS & EQUIP. CO.MFR. OF PISTOLS
FIA - FIAT MILITARY WEAPONS
FDM - FIDELIS ARMS; REDMOND, OREGON
FID - FIDJELAND
FIF - FIELD & FIRESIDE
REM - FIELDMASTER MFG BY REMINGTON ARMS
FFI - FIERCE FIREARMS, LLC; GUNNISON, UTAH
FJ - FIJI USE COUNTRY CODE IF MAKE CAN NOT BE DETERMINED
FD - FINLAND USE COUNTRY CODE IF MAKE CAN NOT BE DETERMINED
TKK - FINLANDIA MODEL OF TIKKA; IMPORTED BY F. I.GARCIA
SAK - FINNBEAR MODEL OF SAKO
FIN - FINNISH LION/FINNISH LION JR.IMPORTED BY INTERARMCO AND F. I.GARCIA
FI0 - FIOCCHI LECCO, ITALY MFGR OF TARGET PISTOLS OND AMMO
FFE - FIRE FOR EFFECT INC. FAYETTE, MO
FSM - FIRE STORM PRODUCTS, WANAMASSA, NJ
YSS - FIREARMS CO.MFR. OF RIFLES
0GA - FIREARMS DEVELOPMENT CO.MFR. OF OMEGA RIFLES
FIM - FIREARMS INTERNATI0NAL, INC.; H0UST0N, TEXAS (TRADE NAME OF INTERARMS) SEE INTERARMS MAK/ITA ASSIGNED SEPERATE MAK CODE 10/2
FIR - FIREARMS INTERNATIONAL CORP.MANUFACTURES KIMEL
FIC - FIREARMS INTERNATIONAL CORP; WASHINGTON D.C. (OUT OF BUSINESS)(FI INDUSTRIES MODEL D 380 CAL
FPF - FIREBIRD PRECISION FOREARMS; MOUNTAINAIR, NEW MEXICO
HEG - FIREBIRDMODEL OF HEGE
FRL - FIRING LINE, WYANDOTE, OK
FCF - FIRST COAST FIREARMS, LLC SAINT AUGUSTINE, FLORIDA
FFF - FIRST FREEDON FIREAMRS, PORTLAND, OR
FFT - FIVE FOUR TACTICAL FREDERICKSBURG, TEXAS
FJV - FJ VOLLMER PLAINFIELD, ILLINOIS
FKB - FK BRNO ENGINEERING, S.R.O. BRNO, CZECH REPUBLIC
FLA - FLAIG'S MFR AND ALSO IMPORTER OF VOERE
FLL - FLAWLESS FIREARMS, LLC SANDY, UTAH
FLE - FLEMING FIREARMS COLLINSVILLE,OK
FFR - FLINT RIVER ARMORY, LLC (FRA) SECTION, ALABAMA
PIF - FLOBERT MFR OF PISTOLET FLOBERT
FL0 - FLORIDA
FLB - FLORIDA FIREARMS ACADEMY,LLC (BOUCAN ARMORY) TAMPA,FL
FLR - FLORIDA FIREARMS IMPORTER AND MANUFACTURER
FL - FLORIDA USE COUNTRY CODE IF MAKE CAN NOT BE DETERMINED
FMI - FM PRODUCTS, INC. (FOXTROT MIKE) BOISE, IDAHO
FMK - FMK FIREARMS, INC (PLACENTIA, CALIFORNIA)
FNH - FNH USA, LLC FREDERICKSBURG, VA
F0A - FOLSOM, H. & D., ARMS CO.
FC - FOND DU LAC BAND OF LAKE SUPERIOR CHIPPEWA MINESOTA USE COUNTRY CODE IF MAKE CAN NOT BE DETERMINED
FBS - FORBES RIFLE, LLC; WESTBROOK, MAINE
F0R - FOREHAND ARMS CO.
W0 - FOREST COUNTY POTAWATOMI COMMUNTY, WISONSIN USE COUNTRY CODE IF MAKE CAN NOT BE DETERMINED
FSK - FORSAKEN ARMS EL CAJON, CA
FY - FORT BELKNAP INDIAN COMMUNITY OF THE FORT BELKNAP RESERVATION OF MONTANA USE COUNTRY CODE IF MAKE CAN NOT BE DETERMINED
WP - FORT MCDERMITT PAIUTE AND SHOSHONE TRIBES OF THE FORT MCDERMITT INDIAN RESERVATION NAVADA AND OREGON USE COUNTRY CODE IF MAKE
FZ - FORT MCDOWELL YAVAPAI NATION, ARIZONA USE COUNTRY CODE IF MAKE CAN NOT BE DETERMINED
GQ - FORT MOJAVE INDIAN TRIBE OF ARIZONA, CALIFORNIA AND NEVADA USE COUNTRY CODE IF MAKE CAN NOT BE DETERMINED
WQ - FORT SILL APACHE TRIBE OF OKLAHOMA USE COUNTRY CODE IF MAKE CAN NOT BE DETERMINED
FWF - FORT WORTH FIREARMS FT WORTH TX
F0E - FOSBERY, G. V.
FTH - FOSTECH MFG, LLC (FOSTECH OUTDOORS) SEYMOUR, INDIANA
F0S - FOSTER HARDWARE CO.
F0I - FOSTER INDUSTRIES HARDWICK, VT;PISTOL FRAMES
TIC - FOX CARBINE MODEL OF TRI-C CORP
FN - FRANCE USE COUNTRY CODE IF MAKE CAN NOT BE DETERMINED
SNA - FRANCESC0 SERENA; MAINLY MARKED ''SERENA''; ITALY
FSU - FRANCISCO SARRUIGARTE
FRB - FRANCONIA IMPORTER ONLY
DSM - FRANK DE HAAS SINGLE-SHOT RIFLES
HAS - FRANK HARRISON ARMS CO.IMPORTED BY H & D FOLSOM FORSICKELS ARMS CO.
WEK - FRANK WESSON
FKD - FRANKFORD ARSENAL FT. LAUDERDALE, FL
FKA - FRANKFORT ARSENAL, INC.FT. LAUDERDALE, FL
FKN - FRANKLIN ARMORY-MORGAN HILL, CALIFORNIA
FKC - FRANKLIN ARMS, CO. MARION, PENNSYLVANIA
FZK - FRANZ KETTNER; SUHL, GERMANY
S0I - FRANZ SODIA MFGR OF SHOTGUNS
ST0 - FRANZ STOCKMFR. OF SHOTGUNS AND PISTOLS
FNZ - FRANZITE
FAE - FRASER ARMS COMPANYFRASER, MI
FTB - FRATELLI BERTUZZIBRESCIA, ITALY; MFR. OF SHOTGUNS
FTP - FRATELLI PIOTTI OR PIOTTI FRATELLI; BRESCIA,ITALY
FTF - FRAZIER'S TACTICAL FIREARMS,LLC CARTERSVILLE,GA
FAC - FREEDOM ARMS CO.
F0M - FREEDOM ORDNANCE MANUFACTURING INC. CHANDLER, IN
FG - FRENCH GUIANA (DEPARTMENT OF GUIANA) USE COUNTRY CODE IF MAKE CAN NOT BE DETERMINED
FP - FRENCH POLYNESIA, TERRITORY OF (FRENCH OVERSEAS TERRITORY) USE COUNTY CODE IF MAKE CAN NOT BE DETERMINED
FR - FRENCH SOUTHERN AND ANTARTIC LANDS, TERRITORY OF THE (FRENCH OVERSEAS TERRITORY) USE COUNTRY CODE IF MAKE CAN NOT BE DETERMIN
SFA - FRESES AMES SCHROEDER-DISTRIBUTOR
FRI - FRIEDR
PIK - FRIEDRICH PICKERT
FGN - FRIGONCLAY CENTER, KS
MNN - FRITZ MANN (MANN WERKE)
FLG - FRITZ WERKE
FR0 - FRONTIER
FRT - FRONTIER (REVOLVER)BRAND NAME
FRN - FRONTIER BULLDOG
FRM - FRONTIER MODEL DERRINGERNUMEROUS MFRS.
LUX - FRUHUF MFG BY LUX
FSF - FULL SPECTRUM FIREARMS MANUFACTURING MADERA, CALIFORNIA
FTA - FULL THROTTLE ARMS INDIANAPOLIS, IN
FUL - FULLERTON
FTN - FULT0N ARM0RY; LAUREL MARYLAND
FUN - FUNDALUM; BUEN0S ARIES ARGENTINA
FUA - FURR ARMS OREM, UT
FUS - FUSION FIREARMS; BINGHAMTON, NEW YORK
FXA - FX AIRGUNS AB-SWEDEN
GAP - G A PRECISION; NORTH KANSAS CITY, MISSOURI
GAC - G. A. C.COPY OF SMITH & WESSON REVOLVER
LEW - G. E. LEWIS MFR OF SHOTGUNS
GMM - G. MCMILLAN COMPANY PHOENIX,AZ MFR OF RIFLES.
WEE - G. S. WEBBER
ZBY - G. ZABALAY SPAIN
GET - G.A.R. ENTERPRISES, LLC; LAC DRUCES, NEW MEXICO
GKG - G.R.A.D.; LAS VEGAS, NEVADA
GTP - G2 PRECISION, LLC PORTER, TX
GAB - GABBETT-FAIRFAX
GB - GABON USE COUNTRY CODE IF MAKE CAN NOT BE DETERMINED
GAD - GALAND ARMS CO.
GLX - GALAXY ENTERPRISES IMPORTER ONLY
GJV - GALEF, J. L., & SON IMPORTER ONLY
GEA - GALENA INDUSTRIES BEAR BUTTE, SD; AMT TYPE FIREARMS, ARCADIA MACHINE & TOOL
RGE - GALESI, RINOMFD. BY RIGARMI
GLI - GALIL ISRAEL SUBMACHINE GUNS
GSL - GALLYON & SONS, LTD.
GM0 - GAM0; SPAIN
GMB - GAMBA MFG.BY LEARMERIA FRATELLI GAMBA (RENATO GAMBA)
GK - GAMBIA, THE USE COUNTRY CODE IF MAKE CAN NOT BE DETERMINED
GAG - GAMBLE STORES/GAMBLE SKOGMO INC.USE GAG ONLY WHEN MODEL IS OTHERTHAN LISTED
MBL - GAME GETTER MODEL OF MARBLE
GAN - GARANTAZADO
GAE - GARATE ANITUA
GYM - GARATE Y MENDIBA
GYA - GARAYSAR, INC. FORT MYERS, FLORIDA
GFD - GARFIELD.22 SEMIAUTOMATIC RIFLES
GGA - GARRETT'S GUN PARTS, LLC (GARRETT'S GUNS AND AMMO) ASHTABULA,OH
GAH - GARRUCHA MFD BY ROSSI
GRC - GARY REEDER CUST0M GUNS, ARIZ0NA
GYG - GARY'S GUNS, INC; WAUKESHA, WI
GAS - GASTINNE RENETTE
GAT - GATLING EARLY MACHINE GUNS
GUC - GAUCHER ARMES S.A. ; FRANCE
TAL - GAUCHOMODEL OF TALA
MRE - GAULOIS REPEATING PISTOL MFD BY MANUFACTURE FRANCAISE D'ARMES ET CYCLES ST. ETIENNE
GZ - GAZA USE COUNTRY CODE IF MAKE CAN NOT BE DETERMINED
GZA - GAZELLE ARMS (HISAR AVCILIK)
GHW - GEAR HEAD WORKS,LLC HILLSBORO, TN
GEX - GEARED & READY ENTERPRISES, LLC CONROE, TEXAS
GE0 - GECO IMPORTER/EXPORTER ONLY
GHA - GEHABOLT-ACTION SHOTGUNS AND MAUSERRIFLES
GLM - GEISSELE AUTOMATICS, LLC NORTH WALES, PA
GIC - GEMINI INVESTMENT CORP.IMPORTER ONLY
GEM - GEMTECH; GEMINI TECHNOLOGIES, BOISE,ID
REI - GENE REISING COMPANY
GSC - GENE SIMILLION CUSTOM; GUNNISON, COLORADO
GFC - GENERAL FIREARMS CO.MFR. OF SHOTGUNS
GEN - GENERAL PRECISION CORP. (G. P. C.)SEE TALON MODEL 10
GSS - GENESIS ARMS, LLC COEUR D'ALENE, ID
GR0 - GEORGE E. ROSE CO. (GEROCO) IMPORTER ONLY
GD - GEORGIA (FORMERLY GRUZINSKAYA) USE COUNTRY CODE IF MAKE CAN NOT BE DETERMINED
GA - GEORGIA USE COUNTRY CODE IF MAKE CAN NOT BE DETERMINED
GCR - GERCAR HANDGUNS
GHM - GERING, H. M.
GSG - GERMAN SPORTS GUNS (IMPORTED BY AMERICAN TACTICAL IMPORTERS)
GEV - GEVARM, S. A.MFR. OF RIFLES
GEL - GEVELOT
GVL - GEVELOT OF CANADAIMPORTER
GWR - GEWEHR WERKS (TK FOREMAN) TIPP CITY, OHIO
RYD - GFT ARMS,LLC (RED RYDER ARMORY) JACKSONVILLE, FLORIDA
GG - GHANA USE COUNTRY CODE IF MAKE CAN NOT BE DETERMINED
GH0 - GHOST FIREARMS, LLC HOLLY HILL, FLORIDA
GHR - GHOST HAMMER ARMS, LLC GILBERT, AZ
CZC - GHOST PRODUCTS, INC (CZ CUSTOM SHOP) MESA, AZ
GBZ - GIBBENS ENGINEERING GROUP, LLC (GIBBZ ARMS) MESA, ARIZONA
GBB - GIBBS RIFLE COMPANY, INC. MARTINSBURG, WV
RG - GIBRALTAR (DEPENDENT TERRITORY OF UNITED KINGDOM) USE COUNTRY CODE IF MAKE CAN NOT BE DETERMINED
GX - GILA RIVER INDIAN COMMUNITY OF THE GILA RIVER INDIAN RESERVATION, ARIZONA USE COUNTRY CODE IF MAKE CAN NOT BE DETERMINED
GIL - GILBERT EQUIPMENT CO.IMPORTER
GIR - GIRSAN, TURKEY
GIA - GISCOSA
GGI - GIUESEPPE GITTI; ITALY (FAMILY GUNMAKERS) _GARDONE VAL TROMPIA CITY IN ITALY NEAR BRESCIA ITALY
GKC - GKC ARMORY SACRAMENTO, CA
GLA - GLADIATOR
GLZ - GLAZE, WILLIAM, & CO.
GLE - GLISENTI MFR OF MILITARY PISTOLS
GLB - GLOBAL ARMS GLENDALE, CALIFORNIA
GBT - GLOBAL DEFENSE ARMS, LLC (TACTICAL DEFENSE ARMS) MAURICE, LOUISIANA
GBM - GLOBAL MACHINE AND TOOL, LLC RHOME, TX
AHC - GLOBAL PRECISION PARTS, INC (ACME MACHINE CORP) OTTOVILLE, OHIO
GLD - GLOCK INC (SMYRNA, GEORGIA) SUBSIDIARY OF ORIGINAL GLOCK GUNS MANUFACTURED IN USA NOT AUSTRIA; ATF REQUESTED SEPERATE LISTIN
GLC - GLOCK, INC.
G0 - GLORIOSO ISLANDS (FRENCH POSSESSION) USE COUNTRY CODE IF MAKE CAN NOT BE DETERMINED
GMG - GM CUSTOM GUNWORKS MERIDIAN, MS
GMA - GM DO NOT CONFUSE WITH GENERAL MOTORS. RIFLES AND SHOTGUNS
GMC - GMF CO. (GUARDIAN MFG. CORP.)
GNR - GNAR, INC. LOUISVILLE, KENTUCKY
GN0 - GNOM/GNOME SINGLE SHOT FLOBERT-TYPE PISTOLS
NQQ - GOLDEN EAGLE MFG BY NIKKO
GLN - GOLDEN STATE ARMSIMPORTER
TLN - GOLDEN WEST (TALON)
G0L - GOLIAT
G0N - GONCZ ARMAMENT, INC.
GNC - GONIC ARMS,INC GONIC,NH; MAKE OF BLACK-POWDER RIFLES
GT0 - GOOD TIME OUTDOORS, INC. OCALA, FLORIDA CORE 15 MODEL
G00 - GOOSE MANUFACTURING INC. SUNNYVALE, CA
GAR - GORDONEY
G0R - GOROSABEL, PEDROPEDRO GOROSABEL MADE IN SPAIN
GYC - GOT YOU COVERED THE WOODLANDS, TEXAS
GPI - GPI MANUFACTURING (CUSTOM GUNWORKS), LLC JACKSONVILLE, FLORIDA
GRM - GRAHAM OR J. GRAHAM & CO., ENGLAND
X0 - GRAND PORTAGE BAND OF LAKE SUPERIOR CHIPPEWA, MINNESOTA USE COUNTRY CODE IF MAKE CANNOT BE DETERMINED
GDP - GRAND POWER S.R.O.; SALVAKIA
HB - GRAND TRAVERSE BAND OF OTTAWA AND CHIPPEWA INDIANS, MICHIGAN USE COUNTRY CODE IF MAKE CAN NOT BE DETERMINED
GH - GRANT HAMMOND CORP.HANDGUNS
STJ - GRANT, STEPHEN, & JOSEPH LAND, LTD.
GWL - GRANT, W. L.DISTRIBUTOR ONLY
GRB - GRAS
GVT - GRAVITAS TACTICAL LOCUST GROVE, VA
GRA - GREAT AMERICAN
GLF - GREAT LAKES FIREARMS & AMMUNITION,LLC SPARTA,MICHIGAN
GWP - GREAT WALL MACHINERY PLANT CHINA
GC - GREECE USE COUNTRY CODE IF MAKE CAN NOT BE DETERMINED
GRL - GREELEY ARMS CO.
GRR - GREEN RIVER RIFLE WORKS ANTIQUE FIREARMS
GBK - GREENBACK SINGLE-SHOT SHOTGUNS
GRE - GREENER MARTINI TYPE OF MARTINI
GRN - GREENFIELD
GN - GREENLAND USE COUNTRY CODE IF MAKE CAN NOT BE DETERMINED
GGG - GREENWOOD GUNS & GEAR, INC.GREENWOOD, SOUTH CAROLINA
GRU - GREGORELLI & UMBERTI
GRF - GREIFELT & CO.
GJ - GRENADA USE COUNTRY CODE IF MAKE CAN NOT BE DETERMINED
GEI - GRENADIER ENGINEERING, INC., SALT LAKE CITY, UTAH
GND - GRENDEL INC.
GGP - GREY GHOST PRECISION, LLC LAKEWOOD, WASHINGTON
GRY - GREYHOUND TACTICAL SOLUTIONS, LLC BEAVERTON, OR
SGE - GRIDLOCK ENTERPRISES, LLC (SEMPER FI GUNS) JACKSONVILLE, NORTH CAROLINA
GRI - GRIEDER, H. F.IMPORTER ONLY
GRH - GRIFFIN & HOWE CUSTOM MANUFACTURER
GGF - GRIFFIN ARMAMENT (HEARING PROTECTION, LLC) DOUSMAN, WISCONSIN
GFA - GRIFFIN ARMS, LLC CHEYENNE, WY
GFF - GRIFFIN PRECISION ARNOLD, CALIFORNIA
GSE - GRIFFITH & SEMPLE
GRT - GRIST MILL MANUFACTURER ROSENDALE, NY
GWG - GRISWOLD & GUNNISON CIVIL WAR REVOLVERS
GRS - GROSS ARMS CO.
GRP - GROUP INDUSTRIES LOUISVILLE KY
GLL - GRULLA ARMAS; SPAIN, MAKER OF RIFLES & SHOTGUNS
GGW - GRUNDHAUSER GUN WORKS (SUBZERO CRYOGENICS, INC.) NORTH BRANCH, MN
GSD - GSD COATINGS,LLC (MODERN MATERIEL) KEYPORT,NJ
GTC - GT VIRTUAL CONCEPTS, LLC NEWMAN, GEORGIA
GP - GUADELOUPE,DEPARTMENT OF USE COUNTRY CODE IF MAKE CAN NOT BE DETERMINED
GM - GUAM USE COUNTRY CODE IF MAKE CAN NOT BE DETERMINED
GU - GUANAJUATO USE COUNTRY CODE IF MAKE CAN NOT BE DETERMINED
GUN - GUARDIANMODEL B. A. CO., VALOR, AND F. I.GARCIA
GT - GUATEMALA USE COUNTRY CODE IF MAKE CAN NOT BE DETERMINED
GF - GUERNSEY, BAILIWICK OF (BRITISH CROWN DEPENDENCY) USE COUNTRY CODE IF MAKE CAN NOT BE DETERMINED
GR - GUERRERO USE COUNTRY CODE IF MAKE CAN NOT BE DETERMINED
GUR - GUEURE
S0S - GUILIO SOSSO
GI - GUINEA USE COUNTRY CODE IF MAKE CAN NOT BE DETERMINED
GUZ - GUIPUZCOANA LA INDUSTRIAL
GUI - GUISASOLA BROS.
GGT - GULGALTA ARMS, SHELBURNE, VERMONT
CRX - GUN CONCIERGE, LLC (CRITICAL FIREARMS RESPONSE SOLUTIONS) OVERLAND, TX
GCI - GUN CRAFTER INDUSTRIES; HUNTSVILLE, ARKANSAS
GNY - GUN ENVY, LLC COLUMBUS, OHIO
GMI - GUN METAL INC. MILLERSVILLE, MD
GUW - GUN WORKS LTD.TONAWANDA, NY
GGB - GUNBUILDS LANETT, ALABAMA
GFZ - GUNFIGHTER TACTICAL, LLC (GFT) SAN DIEGO, CALIFORNIA
GNA - GUNS AMMO & ACCESSORIES INC. ONTARIO, CA
GSF - GUNSMOKE ENTERPRISES OKEECHOBEE,FL; MFR OF AR-15 BASED HANDGUNXM3215
GWK - GUNWERKS, LLC; BURLINGTON, VERMONT
GTV - GUSTAV TICHY (CZECHOSLOVAKIA) GUN MAKER
JGT - GUY T. JONES IMPORTER ONLY
GY - GUYANA USE COUNTRY CODE IF MAKE CAN NOT BE DETERMINED
GWA - GWACS ARMORY, LLC TULSA, OK
GWD - GWARD, POLAND
MBA - GYROJET MFD BY MB ASSOCIATES
HDD - H & D (HENRION & DASSY)
HHE - H & H ENTERPRISES REDWOOD CITY, CA
HNM - H & N MINICRAFT COVINA, CA
HGR - H 3 ENGINEERING SAYBROOK, IL
HST - H&S TACTICAL, LLC FREDERICKSBURG, VIRGINIA
K00 - H. KOON, INC.MFR. OF SNAKE CHARMER SHOTGUNMODEL
K0L - H. M. KOLB MFR OF REVOLVERS
QAK - H. M. QUACKENBUSH
PBY - H. O. PEABODY MFG OF CIVIL WAR RIFLES
LDR - H.A. LINDER; GERMANY
HJI - H.J. INDUSTRIES BROWNSVILLE,TX
HSP - H.S. PRECISION INC.
HAB - HABICHT SHOTGUNS
HHN - HAHN MFG., CO OR P.Y. HAHN MFG.CO MFG OF AIR RIFLES OR AIR PISTOLS
H0C - HAILEY ORDNANCE CO, OKLAHOMA CITY,OK
HT - HAITI USE COUNTRY CODE IF MAKE CAN NOT BE DETERMINED
HLL - HALL, J. H./HALL-NORTH CIVIL WAR RIFLES
HL0 - HALO ARMS; PHOENIXVIILE, PA
JA - HAMADA JAPAN MILITARY ARSENAL OR JAPAN USE COUNTRY CODE IF MMAKE CANNOT BE DETERMINED
HAF - HAMAL
HAM - HAMILTON
HMA - HAMILTON ARMS CUSTOM SERVICES LLC JACKSON, MI
WAM - HAMILTON MODEL OF WHAMO
HRC - HAMILTON RIFLE CO.MFR. OF RIFLES
HMM - HAMMER ARMS LLC CRESTVIEW, FL
HAQ - HAMMERLI
NEA - HAND EJECTOR MODEL OF NEUMANN FRERES
SEN - HANDI-GUN MFD BY SERNA
HAN - HANDY/HANDY AUTO PISTOL/HANDY
HF - HANNAHVILLE INDIAN COMMUNITY, MICHIGAN USE COUNTRY CODE IF MAKE CAN NOT BE DETERMINED
H0V - HANOVER ARMORY, LLC HANOVER, MD
HNV - HANOVER ARMS MFR OF SHOTGUNS
HSZ - HANS SCHWARZ OR H SCHWARZ; BERN SWITZERLAND
LHV - HANS V. LIDL
HAH - HANSCOMB HARDWARE CO.
HTA - HARD TIMES ARMORY INC; ACWORTH, GEORGIA
HRD - HARDENED ARMS, LLC FRIDAY HARBOR, WA
HRL - HARDLINE CUSTOM, LLC JACKSONVILLE, FLORIDA
SUN - HAROLD SUNNGARD
HFA - HARPERS FERRY ARMORY, INC. RANSON, WEST VIRGINIA
HR - HARRINGTON & RICHARDSON OR CHRISTMAS ISLAND,TERRITORY OF (AUSTRALIAN EXTERNAL TERRITORY) USE COUNTRY CODE IF MAKE CANNOT BE D
HGW - HARRIS GUNWORKS PHOENIX, AZ MFR OF BOLT ACTION RIFLES
MCM - HARRIS MCMILLAN GUNWORKS, INC.PHOENIX, AZ; MFR. OF CUSTOM BOLTRIFLES
HHU - HARRISON & HUSSEY; ENGLAND
LAW - HARRY LAWSON CO.
HRF - HARTF0RD ARM0RY; C0LLINSVILLE, CT
HAT - HARTFORD ARMS CO.VARIOUS MFRS.
HAR - HARTMAN
HSK - HASKELL
HGC - HATFIELD GUN COMPANY; TURKEY
HNI - HATT0N INDUSTRIES; INDIAN MILLS NJ
HAP - HAUPTLI
HAU - HAUT RHIN WALTHER-TYPE PISTOLS
HG - HAVASUPAI TRIBE OF THE HAVASUPAI RESERVATION, ARIZONA USE COUNTRY CODE IF MAKE CAN NOT BE DETERMINED
HI - HAWAII USE COUNTRY CODE IF MAKE CAN NOT BE DETERMINED
HKE - HAWK ENGINEERING, INC.NORTHFIELD, IL
HKI - HAWK INDUSTRIES DOMINION ARMS IS BRAND NAME USED BY CANADIAN IMPORTER (CANADA AMMO) GRIZZLY IS MODEL DESIGNATION MADE BY HAW
HWK - HAWKEN EARLY RIFLE MFR
TA0 - HAWKEYES DEFENSE SYSTEMS, LLC (TALON ORDNANCE CO.) YUMA, ARIZONA
M0M - HAWTHORNE (MONTGOMERY WARD)BRAND SOLD BY MONTGOMERY WARD
HDN - HD DEFENSE (DIVINSKY, H.) MECHANICSBURG, PA
HDH - HDH
HEM - HE-MO
HDP - HEAD DOWN PRODUCTS LLC DALLAS, GA
HHF - HEADHUNTERS FIREARMS DBA HHF HUNTINGTON BEACH, CALIFORNIA
HE - HEARD ISLAND & MCDONALD ISLAND, TERRITORY OF (AUSTRALIAN EXTERNAL TERRITORY) USE COUNTRY CODE IF MAKE CAN NOT BE DETERMINED
HTX - HEART OF TEXAS ARMORY,LLC BRYAN, TEXAS
KKR - HEARTLAND AMMUNITION, LLC (KARMA MUNITIONS) WEST MELBOURNE, FLORIDA
HAD - HEAVY ARMOR DIVISION, LLC INDIAN TRAIL, NORTH CAROLINA
HEC - HECKLER & KOCH
HEA - HECLA
HDF - HEDEF SILAH SANAYI AKA HEDEF INDUSTRIES TURKEY
HEJ - HEINEMANN
HZR - HEIZER DEFENSE, LLC PEVELY, MISSOURI
HLD - HELICODOG MODEL OF SHOTGUNS
HFM - HELL FIRE ARMORY LLC WILMINGTON, NC
HAI - HELLENIC ARMS INDUSTRY ATHENS, GREECE
HLT - HELOTES TACTICAL FIREARMS, LLC HELOTES, TX
HBG - HEMBURG MILITARY WEAPAONS
HDR - HENDERSHOT'S SPORTING GOODS, INC. HAGERSTOWN, MD
HDI - HENDERSON DEFENSE INDUSTRIES; LAS VEGAS, NEVADA
HDS - HENDRICK SALES & ENGINEERING CO.IMPORTER ONLY
HEN - HENRY GUN CO.IMPORTED BY CRESCENT
HJJ - HENRY, J. J., & SON MFR OF CIVIL WAR MUSKETS
HGM - HERCULES GAS AND MUNITIONS, MANUFACTURER OF TEAR GAS PROJECTILES & MUNITIONS
HCS - HERCULES VARIOUS MFGRS
SYV - HERE'S SCHRYVER GUN SALES, INC. FORRESTON, ILLINOIS
HRT - HERITAGE ARMS; OPA LOCKA, FL (FORMERLY) QUALITY FIREARM, INCBOUGHT OUT BY HERITAGE MANUFACTURING INC.
HER - HERMAN
WEI - HERMAN WEIHRAUCH MFGR OF ARMINIUS
HEZ - HERMETIC
HET - HERMITAGE (ARMS OR GUN CO.)VARIOUS MFRS.
HR0 - HERO-GEAR LLC; WINCHESTER, TN
JAG - HEROLDMFD. BY JAGER
HEW - HERTER'S INC.U.S. IMPORTER AND MFR.
HES - HESSE LTD INVERGROVE,MN
HEY - HEYM MFR OF RIFLES AND REVOLVERS
HSR - HI SHEAR TECHNOLOGY; SPARKS, NEVADA
HIH - HI-POINTMANSFIELD, OH
HL - HIDALGO USE COUNTRY CODE IF MAKE CAN NOT BE DETERMINED
HIG - HIGGINS, J. C.IN SOME CASES, NUMBERS APPEARINGON BARREL(S) OF HIGGINS WEAPONSARE PRODUCTION NUMBERS, NOTSERIAL NUMBERS.
HHL - HIGH DESERT HEAT,LLC (HDH) FORT MAHAVE, ARIZONA
HDG - HIGH DESERT SPORTING ARMS PALMDALE, CA
HPA - HIGH POWERED ARMORY YOUNGSTOWN, OH
HSM - HIGH STANDARD MANUFACTURING COMPANY; HOUSTON,, TEXAS NOT SAME AS HIGH STANDARD IN CONNECTICUT
HS - HIGH STANDARD OR SAINT HELENA; USE COUNTRY CODE IF MAKE CANNOTBE DETERMINED
ECV - HIJOS DE A. ECHEVERRIA MFR OF VESTA
MAG - HIJOS DE JORGE BASCARAN MFR OF MARKE AND MARTIGRY
HMG - HILL & MAC GUNWORKS, LLC ALPHARETTA, GA
HCB - HILL COUNTRY BLACK RIFLES, LLC SAN ANTONIO, TEXAS
HIP - HISPANO ARGENTINA
HIT - HISTORIC ARMS LLC; FRANKLIN, GEORGIA
H0B - HOBAN MFG. CO.
HDE - HODGE DEFENSE SYSTEMS, INC. SAN ANTONIO, TEXAS
H0G - HOGAN MANUFACTURING LLC GLENDALE, ARIZONA
HJ - HOH INDIAN TRIBE OF THE HOH INDIAN RESERVATION, WASHINGTON USE COUNTRY CODE IF MAKE CAN NOT BE DETERMINED
H0F - HOLLAND FIREARMS CO.IMPORTER OF SHOTGUNS
H0L - HOLLENBECK
HS0 - HOLLIS & SONS MFR OF RIFLES AND SHOTGUNS
HLN - HOLLOWAY AND NAUGHTON, ENGLAND
HLY - HOLLOWAY ARMS COMPANY; FT. WORTH, TX
HLM - HOLMES MANUFACTURER OF MP-83 AMD MP-22
HTN - HOLSTON ENTERPRISES PINEY FLATS,TN
H0A - HOLT, SAM
HD - HONDURAS USE COUNTRY CODE IF MAKE CAN NOT BE DETERMINED
HBF - HONEY BADGER FIREARMS SAN DIEGO, CA
HK - HONG KONG USE COUNTRY CODE IF MAKE CAN NOT BE DETERMINED
HND - HONOR DEFENSE LLC GAINESVILLE, FL
HM - HOPE TRIBE OF ARIZONA USE COUNTRY CODE IF MAKE CAN NOT BE DETERMINED
HPP - HOPPES REPLICAS OF ANTIQUES
H0N - HORNET
HCR - HORNS CUSTOM RIFLES; FLAGSTAFF, AZ
H0S - HORSELY
H0T - HOTCHKISSMACHINE GUN
HPF - HOULDING PRECISION FIREARMS MADERA, CALIFORNIA
WR - HOULTON BAND OF MALISEET INDIANS OF MAINE USE COUNTRY CODE IF MAKE CAN NOT BE DETERMINED
HV - HOURAT ET VIE
HWA - HOWA (JAPAN)_GOLDEN BEAR MODEL, CITADEL-TRADE NAME OF MADEL USED BY LEGACY SPORTS ATF HAS "CITADEL" AS AS MODEL
H0 - HOWLAND ISLAND USE COUNTRY CODE IF MAKE CAN NOT BE DETERMINED
HTT - HTX TACTICAL (G ABREGO INVESTMENTS,LLC) HOUSTON, TEXAS
HP - HUALAPAI INDIAN TRIBE OF THE HUALAPAI INDIAN RESERVATION, ARIZONA USE COUNTRY CODE IF MAKE CAN NOT BE DETERMINED
HBJ - HUBEI JIANGHUA MACHINERY CO. LTD. XIANGYANG, CHINA
HKR - HUBENBECKLER MFR OF DERRINGERS
HUB - HUBERTUS
HSN - HUDSON MANUFACTURING, LLC%TEMPLE TEXAS
HPC - HUEYTOWN PAWN & COIN (HPC) HUEYTOWN, AL
HUP - HUGHES PRECISION PRODUCTS, LLC; INDIAN RIVER, MICHIGAN
HUG - HUGLU COOPERATIVE; TURKEY MANUFACTURER OF SHOTGUNS (DE HAAN SHOTGUNS, LTD) *** NOT SAME AS BUYUK HUGLU MAK/BHG (SILVER EAGLE
HUM - HUMMERIMPORTED BY H & D FOLSOM
HU - HUNGARY USE COUNTRY CODE IF MAKE CAN NOT BE DETERMINED
HUU - HUNT GROUP INTERNATIONAL ARMS & SECURITY KONYA, TURKEY
HNT - HUNTERTOWN ARMS HUNTERTOWN, IN
HUA - HUSAN ARMS, TURKEY MANUFACTURER
HUS - HUSKYMODEL OF HUSQVARNA
KKC - HUSKYMODEL OF KRICO
HWP - HWP ENTERPRISES; MILWAUKEE, WI SLEDGEHAMMER REVOLVERS
HY - HY SCORE
HYD - HYDE
HYS - HYPER-SINGLE
HYA - HYPERION ARMS & AMMO, LLC DANSVILLE, NEW YORK
IMC - I M METAL OR HS PRODUKT; OZALJ, CROATIA
ITG - I. G. I. (ITALGUNS INTERNATIONAL)
INA - I. N. A. (INDUSTRIA NATIONAL DE
IGA - I.G.A.VERANOPOLIS, BRAZIL SHOTGUNS IMPORTED BY STOKER
IMI - I.M.I. (ISRAEL MILITARY INDUSTRIES)MFR. OF UZI SEMIAUTOMATIC MACHINEGUNS_COMPANY NAME CHANGE 5/2006 TO: ISRAEL WEAPON INDUST
IBK - IBARAKI JAPAN
IBA - IBARGUN MODEL OF SHOTGUN
IBE - IBERIA FIREARMS GALION, OH
IC - ICELAND USE COUNTRY CODE IF MAKE CAN NOT BE DETERMINED
IDA - IDAHO ARMORY, LLC RIGBY, IDAHO
FFA - IDAHO DEFENSE LOGISTICS, LLC (FOUNDING FATHERS ARMORY) BOISE, IDAHO
ID - IDAHO USE COUNTRY CODE IF MAKE CAN NOT BE DETERMINED
IDC - IDEAL CONCEAL INC. MONTICELLO, MN
IDP - IDP TACTICAL DIVISION OXNARD, CALIFORNIA
IGD - IG DESTROYER
UGA - IGNACIO UGARTECHEA
TAD - IIA DEFENSE, LLP (2A DEFENSE) MANDEVILLE, LOUISIANA
IKO - IKON WEAPONS, LLC FLORENCE, SC
ILJ - ILJA BRAND OF SHOTGUN MFD. BY F. DADE ESCOPATOS
ILL - ILLINOIS ARMS CO.
IL - ILLINOIS USE COUNTRY CODE IF MAKE CAN NOT BE DETERMINED
IMB - IMBELSHIPPED BY SPRINGFIELD ARMORY
IMP - IMP (IMPERIAL METAL PRODUCTS)MFR. OF REVOLVERS
ILC - IMPACT SPECIALTIES,LLC (RIFLE DYNAMICS) LAS VEGAS,NEVADA
IPD - IMPERIAL DEFENCE SERVICES, LTD., UNITED KINGDOM
IGC - IMPERIAL GUN CO LTD SURREY EN
IME - IMPERIAL-VARIOUS MFRS
IGW - IN GUNS WE TRUST, LLC FORT MEYERS FLORIDA ADDED/ASSIGNED 2/2/16
ICD - INCENDIA ARMS COMPANY, BOERNE,TX
IDE - INDESOL EIBAR, SPAIN
II - INDIA (SIKKIM IS NOW PART OF INDIA; SK FOR REFERENCE ONLY) USE COUNTRY CODE IF MAKE CAN NOT BE DETERMINED
IN0 - INDIAN 0RDNANCE ; C0RP0RATE HEADQUARTERS IS ''0RDNANCE FACT0RY B0ARD''
IAC - INDIAN ARMS CORP.
ISL - INDIAN SALESIMPORTER ONLY
IN - INDIANA USE COUNTRY CODE IF MAKE CAN NOT BE DETERMINED
I0 - INDONESIA (NOW INCLUDES PORTUGUESE TIMOR) USE COUNTRY CODE IF MAKE CAN NOT BE DETERMINED
IDM - INDUMIL COLOMBIA
IAB - INDUSTRIA ARMI BRESCIANE MARCHENO, ITALY
ITM - INDUSTRIAL TECHNICAL MACHINE MADE IN SWITZERLAND
IGL - INGLIS, JOHN BROWNING TYPE PISTOL
ING - INGRAM MFR. OF MACHINE GUNS
IIN - INLAND MANUFACTURING, LLC DAYTON, OHIO
IA0 - INTACTO ARMS, LLC; BOISE, IDAHO
IJB - INTEGRATED ARMAMENT SYSTEMS (IJ BLUM) FELTON, CA
IIA - INTEGRITY ARMS & SURVIVAL, LLC (IAS)JEFFERSON, GEORGIA
ITA - INTERARMS (TRADE NAME USED BY FIREARMS INTERNATIONAL) SEPERATECODE NEEDED PER MICHELE BARNHART ATF TRACING CENTER 10/2011. M
INP - INTERARMS SP.ZO.O. RADOM, POLAND
INR - INTERARMS, LTD. (INTERARMCO)U.S. IMPORTER AND MFR.
INT - INTERCONTINENTAL ARMS IMPORTER ONLY
INY - INTERDYNAMIC CONVERTS TO MACHINE GUNPISTOL COMPANY COMPANY CLOSED 1984 FOR US MODELS AFTER 1984 SEE MAK/INC
IAP - INTERNATIONAL ANTIQUE
IDS - INTERNATIONAL DISTRIBUTORS
INH - INTERNATIONAL HARVESTER
TDE - INTERNATIONAL POLICE STAINLESS 357 REVOLVERS
I0R - INTERORDNASHVILLE, TN; FORMERLYINTERORDNANCE. MFRS. US MADECOPY OF (SOUTH KOREAN) DAEWOOMODEL USAS-12 GAUGE SHOTGUN
INS - INTERSTATE ARMS CO.MFD. BY CRESCENT
I0G - INTL. ORDNANCE GROUP, INC. SAN ANTONIO, TEXAS
INC - INTRATEC USA, INC.MIAMI, FL MFRS. INTRATEL(FORMERLY INTERDYINTERDYNAMICS)
IFA - INVESTARM FABRICA D'ARMI
IGF - INVESTMENT GRADE FIREARMS; MOUNTAIN HOME, ARKANSAS
INV - INVICTA
I0I - IO INC. (DBA-DOING BUSINESS AS; INTER ORDNANCE)
HQ - IOWA TRIBE OF KANSAS AND NEBRASKA USE COUNTRY CODE IF MAKE CAN NOT BE DETERMINED
IW - IOWA TRIBE OF OKLAHOMA USE COUNTRY CODE IF MAKE CAN NOT BE DETERMINED
IA - IOWA USE COUNTRY CODE IF MAKE CAN NOT BE DETERMINED
IR - IRAN USE COUNTRY CODE IF MAKE CAN NOT BE DETERMINED
IQ - IRAQ USE COUNTRY CODE IF MAKE CAN NOT BE DETERMINED
IE - IRELAND (DOES NOT INCLUDE NORTH IRELAND) USE COUNTRY CODE IF MAKE CAN NOT BE DETERMINED
0RB - IRIS, O. H. (ORBEA HERMANOS)MODEL OF ORBEA
IRC - IROCIN 25 CAL
ICR - IRON CITY RIFLE WORKS,LLC INDIAN SPRINGS,ALABAMA
ICA - IRON CLAD ARMORY INC.FORT WENTWORTH, GA.
IRA - IRON RIDGE ARMS LONGMONT, CO
IWM - IRONWORKS MANUFACTURING, LLC TAZEWELL, TENNESSEE
IRP - IRWIN-PEDERSEN ARMS
IAI - IRWINDALE ARMS INCORPORATED
BGI - ISD BULGARIA, LTD. SOFIA, BULGARIA
ISH - ISHAPORISHAPORE, INDIA; STATE-OWNEDARSENAL
IB - ISLE OF MAN (BRITISH CROWN DEPENDENCY) USE COUNTRY CODE IF MAKE CAN NOT BE DETERMINED
ISI - ISRAEL ARMS INTERNATIONAL
ISA - ISRAEL ARMS LTD
IS - ISRAEL USE CODE BY COUNTRY IF MAKE CAN NOT BE DETERMINED
ISC - ISSC AUSTRIA (IMPORTER-AUSTRIAN SPORTING ARMS; US IMPORTER
ITC - ITALO
IT - ITALY (INCLUDES SICILY & SARDINIA) USE COUNTRY CODE IF MAKE CAN NOT BE DETERMINED
IGU - ITHACA GUNS USA LLC; UPPER SANDUSKY, OHIO; NOT SAME AS OTHER ITHACA GUN MFGR.
ITD - ITM ARMS C0MPANY AKA ITM T00L & DIE; CLEVELAND, 0H
IJA - IVER JOHNSON, INC. HARDWICK VERMONT (NEW COMPANY)
IZH - IZHEVSK FORMER SOVIER ARSENAL.MFR. IJ-18SHOTGUN SERIES _SAIGA SERIES OF GUNS , IMEZ
IZM - IZHEVSK MECHANICAL PLANT(IZHMEKH), RUSSIA
JDA - J & D ARMAMENT, LLC DRYDEN, MI
JRE - J & R ENGINEERING CO.
JDM - J D MACHINE TECH INC SAN DIEGO CA
JPN - J P ENTERPRISES ST. L0UIS PARK, MINNES0TA
JPE - J'S PACIFIC ENTERPRISE POMONA,CA; MFR. OF 1911 A-1 TYPE PISTOL SLIDES MAY BE MARKED BROLIN ARMS
JKI - J-K IMPORTS U.S. IMPORTER
JM0 - J. C. MONTGOMERY
PNY - J. C. PENNEY USE PNY ONLY WHEN MODEL IS OTHER THAN LISTED
LAM - J. G. LANDMANN
KRD - J. H. KRIDERMFR. OF CIVIL WAR RIFLES
LA - J. H. LAU & CO.IMPORTER ONLY OR LOUISIANA USE COUNTRY CODE IF MAKE CAN NOT BE DETERMINED
MRL - J. H. MERRILL & CO.MFR. OF CIVIL WAR RIFLES
LEC - J. LLOYD LEWIS
MA0 - J. MANTON & CO.IMPORTED BY H & D FOLSOM
THH - J. THOMAS
JSQ - J.J. SARASQUETA, SPAIN; 2 OTHER SARASQUETA LISTINGS( VICTOR & FELIX) BROTHERS OF JJ ALL SEPERATE COMPANIES
JLD - J.L.D. ENTERPRISES, INC. FARMINGT0N CT. PTR-91 RIFLE (PRECESI0N TARGET RIFLE)
JAB - JABE/ESCOPETAS JABE MFR OF SHOTGUNS
JHA - JACKSON HOLE ARMS CO.JACKSON HOLE, WY
JGF - JACOB GREY FIREARMS LLC DBA JACOB GREY CUSTOM WEST COLUMBIA, SC
JCT - JACOB'S TACTICAL BRENTWOOD, CALIFORNIA
JJC - JACQUEMART, J.
PJA - JAEGER, PAUL
JL - JALISCO USE COUNTRY CODE IF MAKE CAN NOT BE DETERMINED
JM - JAMAICA USE COUNTRY CODE IF MAKE CAN NOT BE DETERMINED
PUD - JAMES PURDEY & SONS RIFLES AND SHOTGUNS
REJ - JAMES REID
JRA - JAMES RIVER ARMORY/ROCKOLA FIREARMS HALETHORPE, MARYLAND
W00 - JAMES WOODWARD & SONS
HW - JAMESTOWN'S S'KLALLAM TRIBE OF WASHINGTON USE COUNTRY CODE IF MAKE CAN NOT BE DETERMINED
JN - JAN MAYEN, (NORWEGIAN TERRITORY) USE COUNTRY CODE IF MAKE CAN NOT BE DETERMINED
JNN - JANA INTERNATIONAL CO.IMPORTER ONLY
JAN - JANNSEN/JANNSEN SONS & CO.MFR. OF SHOTGUNS
JRD - JARD, INC. SHELDON, IOWA
JAR - JARMANN
JRT - JARRETT RIFLES INC, JACKSON, SC
JR - JARVIN ISLAND USE COUNTRY CODE IF MAKE CAN NOT BE DETERMINED
JBC - JB CUSTOMS INC., FORT WAYNE, INDIANA
JBF - JB'S FIREARMS LLC GRANTSBURG, WI
JBI - JBI ARMORY,LLC SANGER,TX
JCM - JCM MFR OF SHOTGUNS
JDW - JDW MANUFACTURING COMPANY PLANO, TEXAS
JED - JEDARMS EDINBORO, PENNSYLVANIA
JSS - JEFF'S SHOOTERS SUPPLY; BIRMINGHAM, AL
JEM - JEM ENTERPRISES GEORGETOWN, TEXAS
HX - JENA BAND OF CHOCTAW INDIANS, LOUISIANA USE COUNTRY CODE IF MAKE CAN NOT BE DETERMINED
JEN - JENKINS SPECIAL
JKS - JENKS, WILLIAM MFR OF CIVIL WAR RIFLES
JFT - JENNINGS FINE TUNING INC.NORTH HOLLYWOOD, CA
JEI - JENNINGS FIREARMS CO.CHINO, CA
JCH - JERICH0 FIREARMS
JDV - JERICHO SERVICES, LLC (DAVINCI MACHINING) PINELLAS PARK, FL
JAM - JERRY'S GUN & AMMO
JE - JERSEY, BAILIWICK OF (BRITISH CROWN DEPENDENCY) USE COUNTRY CODE IF MAKE CAN NOT BE DETERMINED
JJF - JESSE JAMES FIREARMS UNLIMITED, LLC AUSTIN, TEXAS
JGA - JGAMFR. OF RIFLES
JXM - JIANGSU XINSU MACHINERY MANUFACTURING CO. (WUXI BAM) JIANGSU, CHINA
HZ - JICARILLA APACHE NATION, NEW MEXICO USE COUNTRY CODE IF MAKE CAN NOT BE DETERMINED
JIE - JIEFFECO MADE BY ROBES FOR PHOENIX ARMSCO
JGW - JIGSAW WEAPONRY LLC. GIDDINGS, TX
JMZ - JIMENEZ ARMS; C0STA MESA, CA. ; TAKING 0VER F0R ''BRYC0'' CURRENT MAK/BRY
JJR - JJ ROCK CO.,LLC PHOENIX,AZ
JKM - JK MUSTANG, INC ; SACRAMENTO, CALIFORNIA
JLL - JL BILLET, LLC SAN DIEGO, CA
0XG - JMC TACTICAL, LLC (OXGOAD ARMS) CLINTON, PA
JNC - JNC MANUFACTURING RAINIER, OR
JBS - JOE B. SMITH GLENDALE, CA
JB0 - JOE BOB OUTFITTERS, LLC HAY, KANSAS
AZG - JOEJOE ENTERPRISES, LLC (DBA ARIZONA GUNDOG) PEORIA, ARIZONA
JKN - JOEKEN FIREARMS; ARIZONA
J0A - JOHA
SEJ - JOHANN SPRINGER'S ERBINMFR. OF SHOTGUNS
JC - JOHN CAMPION; EAGAN, MINNESOTA
SM0 - JOHN M.SMYTHE MDES. (OR HDW.) CO.VARIOUS MFRS.
L0R - JOHN P. LOWER
JPF - JOHN PRIL FOOTE AKA-J. P. FOOTE
RIG - JOHN RIGBY & CO.
JWL - JOHN W. LINEBAUGHMARYVILLE, MO.
JSA - JOHNNY'S ARMORY MARGATE,FL
J0H - JOHNSON ARMS
J0N - JOHNSON, BYE & CO.PREDECESSOR OF IVER JOHNSON
JI - JOHNSTON ATOLL USE COUNTRY CODE IF MAKE CAN NOT BE DETERMINED
J0T - JOHNSTON-TUCKER MFR OF CARBINES
J0J - JOJO'S GUN WORKS LLC; SOUTHINGTON, CT
J0 - JORDAN USE COUNTRY CODE IF MAKE CAN NOT BE DETERMINED
JPS - JPS MANUFACTURING, LLC SCOTTSDALE AZ
JRW - JRW SPORTS; EDGEWATER, FL
JU - JUAN DE NOVA ISLAND USE COUNTRY CODE IF MAKE CAN NOT BE DETERMINED
LEY - JUBALA MFG BY LARRANAGA Y ELARTZA
JUG - JUGGERNAUT TACTICAL, INC. ORANGE, CA
JUK - JUKAR
JRC - JUST RIGHT CARBINES, LLC; CANANDAIGUA, NEW YORK
JUS - JUST, JOSET
JTC - JUSTICE, P. S.MFR. OF CIVIL WAR RIFLES
JVI - JV INDUSTRIES, LLC CORONA, CA
JVP - JV PRECISION SEYMOUR, CONNECTICUT
JWM - JW MANUFACTURING, LLC (WOLF PACK ARMORY) FAIRMONT, WV
KGS - K AND G SERVICESHESTER,PA, MAKER OF INGRAM TYPEMIAUTOMATIC FIREARMS.
KSS - K I S S TACTICAL MARICOPA, AZ
KMA - K&M ARMS CHANDLER, ARIZONA
SSK - K-MARTUSE ONLY WHEN MFR. IS UNKNOWN
KNR - K. K. NIHON RYOJU SEIKE SEISAKUSHO MFR OF SHOTGUNS
KKS - K. K. SNASHIN SHOJUKI MFR OF SHOTGUNS
KAB - KAB ARMS LLC SPRING, TX
KFF - KAFFIR SINGLE SHOT SHOTGUN
KAS - KAHOUT & SPOL
KHR - KAHR ARMS BLAUVELT, NEW YORK; MFG IN WORCESTER, MASS.
IF - KAIBAB BAND OF PAIUTE INDIANS OF THE KAIBAB INDIAN RESERVATION, ARIZONA USE COUNTRY CODE IF MAKE CAN NOT BE DETERMINED
KCF - KAISER CUSTOM RIFLE ORLANDO FL
KDS - KAISER DEFENSE; SAN DIEGO, CALIFORNIA
KSP - KAISER SHOOTING PRODUCTS LLC AKA KSP US OR KAISER US TUCSON, AZ
KKH - KALASHNICOHN, LLC (THE FOB) PHOENIX, AZ
SX - KALASHNIKOV-DESIGNER SOVIET AK MACHINE GUN
IG - KALISPEL INDIAN COMMUNITY OF KALISPEL INDIAN RESERVATION, WASHINGTON USE COUNTRY CODE IF MAKE CAN NOT BE DETERMINED
KAM - KALTMANN
KMM - KAMMLER WORKS, LLC GILMER, TX
KCA - KANSAS CITY ARMS
KS - KANSAS USE COUNTRY CODE IF MAKE CAN NOT BE DETERMINED
KAP - KAPPORA
KLD - KARL LIPPARD DESIGNS, COLORADO SPRINGS, COLORADO
KRR - KARRI'S GUNS (PODUNK, INC.) OLATHE, KANSAS
SCE - KASCHIE (KARL SCHIEDER) MFR OF DERRINGERS
KTF - KAUFMANN TACTICAL FIREARMS AKA KTF FRESNO, CALIFORNIA
IH - KAW NATION, OKLAHOMA USE COUNTRY CODE IF MAKE CAN NOT BE DETERMINED
KAW - KAWAGUCHIYA FIREARMS CO.
KT - KAZAKHSTAN USE COUNTRY CODE IF MAKE CAN NOT BE DETERMINED
KAA - KAZAR CUSTOM ARMS NAPA, CALIFORNIA
KSI - KBI, INC.HARRISBURG, PA; KASSNAR BROTHERSINTERNATIONAL
KKL - KC'S KUSTOM CREATIONS, LLC MAYSVILLE, NC
KCG - KCG AKA KIWI'S CUSTOM GUNS RIVERBANK, CA
KDF - KDF, INC.SEQUIN, TX MFR OF BOLT ACTION HUNTING RIFLES
KDM - KDM AKA KILLBREW DESIGN AND MANUFACTURING LLC RUTLEDGE, AL
KEA - KE ARMS PHOENIX, ARIZONA
KEB - KEBLER
KTC - KEL-TEC COCOA,FL; 9MM PISTOL, PART OF CNCINDUSTRIES.
KLB - KELBYS INC.N0RTH LAWRENCE, 0H
KC0 - KENCO ARMS, LLC WILLIS, TEXAS
KDU - KENDU
KEN - KENTUCKIAN DISTRIBUTED BY INTERCONTINENTAL ARMS
KY - KENTUCKY USE COUNTRY CODE IF MAKE CAN NOT BE DETERMINED
KE - KENYA USE COUNTRY CODE IF MAKE CAN NOT BE DETERMINED
KEC - KERRCO
KES - KESSLER ARMS CORP.
KEL - KESSLER MFR OF SHOTGUNS
KZL - KESZLER
0Y - KEWA PUEBLO, NEW MEXICO (FORMERLY PUEBLO OF SANTO DOMINGO,NEW MEXICO) USE COUNTRY CODE IF MAKE CANNOT BE DETERMINED
IK - KEWEENAW BAY INDIAN COMMUNITY, MICHIGAN USE COUNTRY CODE IF MAKE CAN NOT BE DETERMINED
KEY - KEYSTONE ARMS CO.BRAND NAME OF E. K. TYRON
KMW - KEYSTONE MACHINE WORKS (KEYSTONE ARMORY) SAND SPRINGS, OKLAHOMA
KSA - KEYSTONE SPORTING ARMSMILTON,PA, MFR'S CRICKET MODELCAL RIFLE
KAL - KHALAN WEAPONRY, HARRISBURG, ARKANSAS
KHN - KHAN; ISTANBUL TURKEY
ZE - KIALEGEE TRIBE TOWN OKLAHOMA USE STATE CODE IF MAKE CODE IS NOT AVAIABLE
WU - KICKAPOO TRADITIONAL TRIBE OF TEXAS USE COUNTRY CODE IF MAKE CAN NOT BE DETERMINED
IV - KICKAPOO TRIBE OF INDIANS OF THE KICKAPOO RESERVATION IN KANSAS USE COUNTRY CODE IF MAKE CAN NOT BE DETERMINED
KK - KICKAPOO TRIBE OF OKLAHOMA USE COUNTRY CODE IF MAKE CAN NOT BE DETERMINED
KCS - KICKIN STEEL CUSTOM ARMS (KSCA) FENTON, MI
KID - KIDD INNOVATIVE DESIGN, LLC-MCQUEENEY, TEXAS
KSZ - KIES FIREARMS, LLC STILLWATER, MN
KFU - KIFARU INTL, WHEATRIDGE, COLORADO (LICENSE NAME-DESIGN SMITHLLC.) USE TRADE NAME
KIB - KIMBALL ARMS CO.MFR. OF PISTOLS
KIE - KIMBER
KIM - KIMEL/KIMEL IND.NOT ASSOCIATED WITH FIREARMSINTERNATIONAL CORP.
KDV - KINETIC DEVELOPMENT GROUP, LLC (KDG) SEYMOUR, CONNECTICUT
NIT - KING NITRO VARIOUS MFGRS
KI - KINGMAN REEF USE COUNTRY CODE IF MAKE CAN NOT BE DETERMINED
KAR - KINGS ARSENAL ABILENE, TEXAS
KIZ - KINGS GUNSMITH SHOP, INC. PINEY FLATS, TENNESSEE
KTI - KINTREK, INC OWENSBORO KY; MFRS .22 LR CALIBER SEMIAUTO RIFLE MODEL KBP-1
KW - KIOWA INDIAN TRIBE OF OKLAHOMA USE COUNTRY CODE IF MAKE CAN NOT BE DETERMINED
KB - KIRBATI (FORMERLY GILBERT ISLANDS) USE COUNTRY CODE IF MAKE CAN NOT BE DETERMINED
KII - KIRICI SILAH SANAYI BEYSEHIR,KONYA, TURKEY
KIR - KIRIKKALE MKE-MAKINA VE KIMYA ENDUSTRISI KURUMU _AMERICAN TACTICAL 92, AT94K, AT94P, C92 (MODELS)
KIL - KIRTLAND BROS.
KJ0 - KJ0BENHAUNS T0IHUUS,'KJ0BENHAVNS'
WX - KLAMATH TRIBES, OREGON USE COUNTRY CODE IF MAKE CAN NOT BE DETERMINED
KLG - KLEIN GUENTHER
KMP - KMP CLASSIC ARMS, INC; MANSFIELD, OHIO
KKB - KNICKERBOCKER MFD BY CRESCENT, AMERICAN GUN CO.,AND STEVENS
KNH - KNIGHT & HALE, CADIZ, KENTUCKY-MUZZLE LOADERS/ BLACK POWDER FIREARMS
KNI - KNIGHT ARMAMENT VERO BEACH, FL ALSO KNIGHT MANUFACTURING _(AS OF 9/26/12 KNIGHT MANUFACTURING SAME MFG ADDRESS IS DEEMED TO 
KNM - KNIGHT MANUFACTURING TITUSVILLE, FLORIDA (PREVIOUS CODED AND MFG ALONG WITH KNIGHT ARMAMENT OUT OF VERO BEACH, FL. AS OF 9/2
KGB - KNIVES, GUNS, AND BULLETS LLC SAN TAN VALLEY, ARIZONA
SHE - KNOCKABOUT MODEL OF SHERIDAN
K0B - KOBOLD
K0A - KOBRA
K0D - KODIAK MFG. CO.
KFS - KOFS LTD.; TURKEY
K0H - KOHNKE GUN WORKS REDWOOD FALLS,MN; MANUFACTURES BLACK POWDER PISTOLS
K0K - KOKURA
KLR - KOLAR ARMS RACINE, WI
K0I - KOLIBRI; REHBURG AUSTRIA; MAD BE GEORGE GABNER
KD0 - KOMANDO AV SA. TIC. LTD. STI. (KOMANDO AV) ISTANBUL, TURKEY
K0M - KOMMER, THEODOR
KNG - KONGSBERG; NORWAY
KB0 - KORA BRNO CZECHOSLOVAKIA
K0R - KORTH MFR OF REVOLVERS
KV - KOSOVO USE COUNTRY CODE IF MAKE CAN NOT BE DETERMINED
KOT - KOTE OF ARMS, LLC (KOA) MELBOURNE,FLORIDA
IZ - KOTENAI TRIBE OF IDAHO USE COUNTRY CODE IF MAKE CAN NOT BE DETERMINED
KRA - KRAG MILITARY WESPONS
KRS - KRAL AV SANAYI, TURKEY
KRU - KRAUSE ARMS AMERICA (KRAUSE, PJ) YORK, SC
KRW - KRAUSEWERK SAN MATEO, CA
KRB - KREBS CUSTOM INC.; WAUCONDA, IL
KRE - KREPP
KRI - KRIEGHOFF FIREARMS CO.MFR. OF SHOTGUNS AND DOUBLE-BARRELRIFLES
KRK - KRINKS; NAPLES, FLORIDA M97 SPORTING RIFLES
KSC - KSC ENTERPRISES, LLC (ROBERT'S DEFENSE) OSHKOSH, WISCONSIN
KSN - KSN INDUSTRIES MFR OF KAREEN MARK II 9MMPISTOL. MANUFACTURED IN KFARSABA, ISRAEL.
KTG - KTG FIREARMS
KUA - KUANDIAN; CHINA (MAKE REPLICA WINCHESTER 1897 SHOTGUN)
KU - KUWAIT USE COUNTRY CODE IF MAKE CAN NOT BE DETERMINED
KZ - KYRGYZSTAN USE COUNTRY CODE IF MAKE CAN NOT BE DETERMINED
LCM - L C CUSTOM MACHINE (LIMCAT CUSTOM) NEVADA _** LIMCAT CUSTOM NOT LISTED ON LICENSE AS A TRADE NAME ** L C CUSTOM MACHINE IS L
LTT - L D TACTICAL ARMS UPLAND, CALIFORNIA
LSC - L. E. S. CORP.
RMN - L. R0MAN0 C0.; PENNELLVILLE, NY
LJA - L.E. JURRAS & ASS0CIATES; PRESC0TT, ARIZ0NA
LAS - LA FRANCE SPECIALTIES MFRS OF PISTOLS
MAF - LA SALLEMFD. BY MANUFRANCE
WZ - LAC COURTE OREILLES BAND OF LAKE SUPERIOR CHIPPEWA INDIANS OF WISCONSIN USE COUNTRY CODE IF MAKE CAN NOT BE DETERMINED
LP - LAC DU FLAMBEAU BAND OF LAKE SUPERIOR CHIPPEWA INDIANS OF THE LAC DU FLAMBEAU RESERVATION, WISCONSIN USE COUNTRY CODE IF MAKE
JB - LAC VIEUX DESERT BAND OF LAKE SUPERIOR CHIPPEWA INDIANS, MICHIGAN USE COUNTRY CODE IF MAKE CAN NOT BE DETERMINED
LAC - LACHA MODEL OF SHOTGUN
LCL - LACLEDE GUN COMPANY; BELGIUM
LAD - LADIES PET
LAT - LAHTI MILITARYU WEAPONS MFG BY HUSQUVARNA OR KIVAARI TEHDAS
LKE - LAKEFIELD SALES LIMITED LAKEFIELD CANADA
LKM - LAKESIDE MACHINE, POUND, WISCONSIN
LMS - LAMES
LAP - LAMPO
LAB - LANBER ARMAS
LZZ - LANCASTER ARMORY, LLC (PETRONOV ARMAMENT) PHOENIX, ARIZONA
LCS - LANCASTER CONSULTING OR LANCASTER ARMS; GOODYEAR, ARIZONA
LNC - LANCER SYSTEMS LP ALLENTOWN, PENNSYLVANIA
LTL - LANCO TACTICAL, INC. ELIZABETHTOWN, PENNSYLVANIA
LTC - LANTAC USA, LLC FORT WORTH, TEXAS
LS - LAOS USE COUNTRY CODE IF MAKE CAN NOT BE DETERMINED
LMF - LAR MANUFACTURING WEST JORDAN UTAH
LAA - LARAND MFR OF SILENCERS
LA0 - LAROSE
LMI - LARRANAGA, MIGUEL MFR OF SHOTGUNS
LGI - LARRY'S GUNS,INC (LGI) GRAY,MAINE
LRT - LARUE TACTICAL; LEANDER, TEXAS
XR - LAS VEGAS TRIBE OF PAIUTE INDIANS OF THE LAS VEGAS INDIAN COLONY, NEVADA USE COUNTRY CODE IF MAKE CANNOT BE DETERMINED
LGB - LASAGABASTER HERMANOS EIBAR, SP
LRE - LASSERRE S.A.; ARGENTINA
LZL - LASZLO IMPORTER ONLY
LT - LATVIA USE COUNTRY CODE IF MAKE CAN NOT BE DETERMINED
LCW - LAUER CUST0M WEAP0NRY (LCW MANUFACTURING) IS TRADE NAME; CHIPPAWA FALLS, WI
LAF - LAUF PENCE
LWS - LAW WEAPONS AND SUPPLY (R.C. BEVIS) NAPERVILLE, ILLINOIS
LMC - LAWTON MACHINE LLC, DILLION, MT
LYK - LAYKE TACTICAL LLC PHOENIX, AZ
LAZ - LAZZERONI TUCSON,AZ MFR'S OF REVOLVERS
LBA - LE BASQUE
MAB - LE CAYALIER MFG BY MANUFACTURE AUTOMATIQUESDE BAYONNE
LED - LE DRAGON
LEK - LE FULGOR
LEM - LE MAJESTIC
LE0 - LE MARTINY
LEP - LE MAT
LEQ - LE NOVO
LER - LE PAGE
LET - LE PROTECTEUR
LEU - LE RAPIDE
LEX - LE SANS PAREIL; BRAND NAME FOR: BRAND D'ARMES DES PYRENEES/ AUDAX
LSS - LE SECOURS
LFA - LE TOUT ACIER DUC
LEA - LEAD STAR ARMS LLC SUMMERVILLE, SC
LTY - LEADER ARMS TECHNOLOGY; TRABZON, TURKEY _ADDED/ASSIGNED 10/28/15
LDY - LEADER DYNAMICS
LN - LEBANON USE COUNTRY CODE IF MAKE CAN NOT BE DETERMINED
LBC - LEBEAU-COURALLY
LEB - LEBEL MILITARY WEAPONS
LDS - LEDESMA ARMS CHINO HILLS, CALIFORNIA
LRM - LEE ARMORY, LLC PHOENIX, ARIZONA
LEE - LEE ARMS CO.
LEG - LEE SPECIAL/LEE'S MUNNER SPECIAL IMPORTED BY H & D FOLSOM
LFS - LEE'S FIREARMS CO.MFR. OF CIVIL WAR RIFLES
PAH - LEE-ENFIELD CUSTOM NUMBER 1 OR 4 MODEL OF PARKER HALE RIFLE
LRN - LEECH & RIGDON CIVIL WAR REVOLVERS
LL - LEECH LAKE BAND OF CHIPPEWA MINNESOTA USE COUNTRY CODE IF MAKE CAN NOT BE DETERMINED
LEI - LEFAUCHEUX IMPORTED
LEF - LEFEVER MFR OF SHOTGUNS
LEN - LEFNER
LEJ - LEFT DESTROYER
LGM - LEGEND MFG, INC (AMERICAN PRIDE) MCKINNEY, TX
LGD - LEGENDARY ARMS WORKS (TROP MANUFACTURING, LLC) REINHOLDS, PENNSYLVANIA
LEL - LEGIA DEMONTANTS
LGN - LEGION FIREARMS, LLC TEMPLE, TEXAS
LND - LEINAD DUCKTOWN,TN
LWR - LEITNER WISE RIFLE C0., INC.; ALEXANDRIA, VIRGINIA_ COMPANY HAS CHANGED ITS NAME TO: "LAND WARFARE RESOURCES CORP." (DBA-LWR
LDA - LENOIR & LOGUE
LEV - LEPCO
LBI - LES BAER CUSTOM INC LICENSED IN MILLAN AND HILLSDALE,IL CUSTOM GUNSMITH, MAKES PISTOLS
LE - LESOTHO USE COUNTRY CODE IF MAKE CAN NOT BE DETERMINED
LEZ - LESTER, L. M. & G. H.
LFB - LEWES/LEWIS MACHINE GUNS
LWT - LEWIS MACHINE & TOOL, MILAN, IL
SGD - LH GUN CO.SPRINGFIELD ARMORY M1A_(TRUE SPRINGFIELD GENESEO, IL)
LIB - LIBERTY ARMS CO.MFD. BY ROHM, ARMALITE, HERBERTSCHMIDT, AND RECK. IMPORTER ANDDISTRIBUTOR
LAI - LIBERTY ARMS INTERNATIONAL, LLC VICTORIA, TEXAS
LRW - LIBERTY ARMS WORKS WEST CHESTER,PA MANUFACTURES PISTOLS
LGA - LIBERTY GUNS AND AMMO VALLEY SPRINGS, CA
LMG - LIBERTY MANUFACTURING GROUP, LLC HENRICO, VA
LBR - LIBERTY SHOT GUNS MFG BY HOOD FIREARMS CO AND HOPKINS & ALLEN
LBY - LIBERTY SUPPRESSORS (SAYLOR'S MACHINE & DESIGN WORKS, LLC) TRENTON, GEORGIA
LBT - LIBERTY TACTICAL, LLC-WAUSEON, OHIO
LY - LIBYA USE COUNTRY CODE IF MAKE CAN NOT BE DETERMINED
LI - LIECHTENSTEIN USE COUNTRY CODE IF MAKE CAN NOT BE DETERMINED
LI0 - LIEGEOISE MADE BY ROBOR & CO
LIP - LIG (LA INDUSTRIA GUIZPUCOANA)
LIT - LIGHTNING (PISTOL)
WHI - LIGHTNING MODEL SAME AS WOLVERINE
LTS - LIGHTNING STRIKES TECHNOLOGY LLC; WILLIAMSTOWN, WEST VIRGINIA
LIG - LIGNOSE MFD BY A. G. LIGNOSE
LLD - LILLARD MANUFACTURING, INC. WOODLAND, CALIFORNIA
LCT - LIMCAT CUSTOM INTERNATIONAL, LLC SPARKS, NEVADA
LIN - LINCOLN
LID - LINDSAY MFG. CO.TWO-SHOT CIVIL WAR RIFLES
LXC - LINYI JUNXING CHEETAH CHINA
LDI - LIONADI, INC. PHOENIX, AZ
LHT - LIONHEART INDUSTRIES, LLC; REDMOND, WASHINGTON
SYL - LIRA MFG BY SYSTEMA LA LIRA
LTG - LITHGOW GOVERNMENT MILITARY ARSENAL
LH - LITHUANIA USE COUNTRY CODE IF MAKE CAN NOT BE DETERMINED
LIR - LITTLE ALL RIGHT (PALM PISTOL)
LIA - LITTLE PAL
JD - LITTLE RIVER BAND OF OTTAWA INDIANS, MICHIGAN USE COUNTRY CODE IF MAKE CAN NOT BE DETERMINED
LIM - LITTLE TOM
JF - LITTLE TRAVERSE BAY BANDS OF ODAWA INDIANS, MICHIGAN USE COUNTRY CODE IF MAKE CAN NOT BE DETERMINED
LMT - LIVIAOITL (NAME STAMPED UPSIDE COPY OF 45 CAL U.S. PISTOL
LJG - LJUNGMAN
LJU - LJUTIC ARMS CO.MFR. OF SHOTGUNS
L0B - LOBO
LB - LOBSINGLE-SHOT PISTOLS OR LIBERIA USE COUNTRY CODE IF MAKE CAN NOT BE DETERMINED
L0E - LOEWE, LUDWIG
LKI - LOKI WEAPON SYSTEMS, INC; ATOKA, OKLAHOMA
LBD - LOMBARDI AMERICAN WEAPONS (PHIL'S RELOADING SUPPLIES) FRESNO, CA
LSM - LONE STAR ARMAMENT; STEPHENVILLE, TX (DO NOT CONFUSE WITH '' LONE STARRIFLE COMPANY''
L0A - LONE STAR ARMORY; FORT WORTH, TEXAS
LSR - LONE STAR RIFLE COMPANY; CONROE,TX; REMINGTON ROLLING BLOCK REPLICAS
LWF - LONE WOLF R & D, LLC; OLDTOWN, IDAHO
LDT - LONG DOG TACTICAL LLC WEST JORDAN, UT
L0N - LONG RANGE WINNER/LONG RANGE WONDER BRAND OF SEARS & ROEBUCK
L0I - LONGINES
LCN - LORCIN ENGINEERING CO, INC. FIREARMS, RIVERSIDE, CA
L0D - LORD ARMS / LORD, INC; MISSOULA, MONTANA
L0S - LOSADA
L0V - LOVELL ARMS CO.MFR. OF CUSTOM RIFLES
JG - LOVELOCK PAIUTE TRIBE OF THE LOVELOCK INDIAN COLONY, NEVADA USE COUNTRY CODE IF MAKE CAN NOT BE DETERMINED
L0W - LOWELL ARMS CO.
JH - LOWER BRULE SIOUX TRIBE OF THE LOWER BRULE RESERVATION, SOUTH DAKOTA USE COUNTRY CODE IF MAKE CAN NOT BE DETERMINED
JJ - LOWER ELWHA TRIBAL COMMUNITY OF THE LOWER ELWHA RESERVATION, WASHINGTON USE COUNTRY CODE IF MAKE CAN NOT BE DETERMINED
XS - LOWER SIOUX INDIAN COMMUNITY IN THE STATE OF MINNESOTA USE COUNTRY CODE IF MAKE CAN NOT BE DETERMINED
L0Y - LOYOLA
LRB - LRB OF LONG ISLAND INC. (TRADE NAME-LRB ARMS) FLORAL PARK,NY(ATF WILL LIST BY TRADE NAME)
LSA - LSA
LMR - LU-MAR ITALY
LST - LUCHENI, STEFANO
LUC - LUCHSGEWEHRFABRIK MFR OF FIREARMS
P0N - LUCIUS W. POND
LUZ - LUCZNIK METAL FACTORY ALSO SEE REFERENCE TO ZAKLADY METALOWE LUCZNIK RADOM, POLAND,LISTED UNDER MAK/LUZ AMERICAN TRANSLATION
LUG - LUGER VARIOUS MANUFACTURERS (IF NO ADDITIONAL MARKINGS THESE SHOULD BE CODED: MAK/ZZZ WITH "LUGER IN MISC FIELD-PER ATF NTC 
JK - LUMMI TRIBE OF THE LUMMI RESERVATION, WASHINGTON USE COUNTRY CODE IF MAKE CAN NOT BE DETERMINED
LU - LUN EBRUG OR SAINT LUCIA USE COUNTRY CODE IF MAKE CAN NOT BE DETERMINED
LUN - LUNA
LUS - LUSA, USA WEBSTER, NEW HAMPSHIRE
LUE - LUTETIA
LUT - LUTTICK
LX - LUXEMBOURG USE COUNTRY CODE IF MAKE CAN NOT BE DETERMINED
HMD - LUXUS ARMS LLC DBA HM DEFENSE MOUNT ORAB, OH
LYM - LYMAN GUN CO.PERCUSSION RIFLES AND REVOLVERS
LZH - LZH
MMD - M & M, INC. (M & M INDUSTRIES); NORTHGLENN, COLORADO ADDED/ASSIGNED 12/23/15
MGI - M GROUP INTERNATIONAL (INTL), DELTONA, FLORIDA (NOT THE SAME AS MGI-MG INDUSTRIES INC BANGOR, ME)
MKB - M K BALLISTIC SYSTEMS HOLLISTER,CA
MYG - M Y GUNS TALENT, OREGON
MBC - M. A. C.
MAT - M. A. T.
MLE - M. L.
ZUL - M. ZULAICA & CO. (ZULAICA Y CIA)
MVC - M.V.T. DICONTENTO EUGENIO
MPR - M4 PRECISION, LLC FORT COLLINS CO
RCC - M8 FAMILY ENTERPRIZES, LLC (RACCOON TACTICAL) OCEAN SPRINGS, MISSISSIPPI
MCS - MA CUSTOMS, LLC JESUP, GEORGIA
MIX - MAC (MILITARY ARMAMENT CORP.)MFR OF INGRAM SUBMACHINE GUNS
0C - MACAU (FORMERLY MACAO) USE COUNTRY CODE IF MAKE CANNOT BE DETERMINED
ZD - MACEDONIA USE COUNTRY CODE IF MAKE CANNOT BE DETERMINED
MCI - MACHINE CRAFTERS, INC.
MGC - MACHINIST GROUP CORP. (MGC TACTICAL) GILROY, CALIFORNIA
ASK - MACPHERSON FIREARMS,LLC%(A7K/ALPHA SEVEN KILO)EPPING NEW HAMPSHIRE
MP - MADAGASCAR (INCLUDED IN MALAGASY REPUBLIC) USE COUNTRY CODE IF MAKE CANNOT BE DETERMINED
IM - MADEIRA ISLANDS USE COUNTRY CODE IF MAKE CAN NOT BE DETERMINED
MIC - MADISON IMPORT CO.IMPORTED ONLY
MAD - MADSEN MACHINE GUNS
MUE - MAELEER
MTY - MAG TACTICAL SYSTEMS, LLC NEWBURGH, INDIANA
MGN - MAGNUM RESEARCH MINNEAPOLIS,MN IMPTR FOR ISRAELI MILITARY INDUSTRY TEL AVIVE ISRAEL
MGT - MAGTECH RECREATIONAL PRODUCTS, INC.IMPORTERS OF CBC PRODUCTS, INC.SHOTGUN OF BRAZIL
MJM - MAJOR METALS, INC. (MM SALES) HOUSTON, TX
JP - MAKAH INDIAN TRIBE OF THE MAKAH INDIAN RESERVATION, WASHINGTON USE COUNTRY CODE IF MAKE CAN NOT BE DETERMINED
MAV - MAKAROV- SOVIET MILITARY FIREARMS ( IF NO ADDITIONAL MARKINGS ARE AVAILABLE THESE SHOULD BE CODED: MAK/ZZZ WITH MAKROV IN TH
MF - MALAWI USE COUNTRY CODE IF MAKE CAN NOT BE DETERMINED
MZ - MALAYSIA USE COUNTRY CODE IF MAKE CAN NOT BE DETERMINED
MV - MALDIVES USE COUNTRY CODE IF MAKE CAN NOT BE DETERMINED
ML - MALI USE COUNTRY CODE IF MAKE CAN NOT BE DETERMINED
MY - MALTA USE COUNTRY CODE IF MAKE CAN NOT BE DETERMINED
MAH - MALTBY & HENLEY
MCC - MALTBY, CORLISS & CO.
MSP - MAN-STOPPER MODEL OF LANCASTER,WEBLEY, AND OTHERS
KH - MANAHIKI ISLAND USE COUNTRY CODE IF MAKE CAN NOT BE DETERMINED
MCH - MANCHESTER ARMSLENOR TENN
MDL - MANDALL SUPPLY CO.IMPORTER
MTT - MANHATTAN POCKET REVOLVER
MB - MANITOBA USE COUNTRY CODE IF MAKE CAN NOT BE DETERMINED
MAN - MANNLICHER
STE - MANNLICHER-SCHOENAUER MFD BY STEYR
MAC - MANNLICHER/CARCANO MILITARY WEAPONS
MTI - MANTIS ARMS, LLC CEDAR CITY, UTAH
MDM - MANUFACTURE IMPERIAL DE MUTZIG
MHN - MANURHIN, S. A.FRENCH-MADE WALTHER
MTH - MARATHON PRODUCTS, INC.
MCT - MARCEL THYS; BELGIUM
MCF - MARCOLMAR FIREARMS; RICHMOND, INDIANA
MRG - MARGOLIN HANDGUN MODEL
MK - MARIANA ISLANDS USE COUNTRY CODE IF MAKE CAN NOT BE DETERMINED
MRK - MARKS BRAND OF HUNTER ARMS
MAP - MARKSMAN PRODUCTS MFG OF AIR GUNS
MAK - MARKWELL ARMS CO.MFRS. OF REPLICAS OF ANTIQUES
MRI - MAROCCINIMFD. BY BRESCIA
MRF - MAROCHI & FIGLI MFG OF SHOTGUNS
MBR - MARS (PISTOLS)VARIOUS MFRS.
MSC - MARSHWOOD BRNAD OF CHARLES WILLIAMS STORE
MUC - MARSON, SAMUEL, & CO.
MAW - MARSTON, WILLIAM M. MFR OF CIVIL WAR CARBINES
MZA - MARTE MODEL OF MUGURAZA
MBB - MARTEAU
UGB - MARTIN UGARTEBURU
MTN - MARTINI/MARTINI-HENRYSINGLE-SHOT RIFLES
0KC - MARUBENI AMERICA CORP.IMPORTS FROM OLIN-KODENSHA (JAPAN);TRADE NAME--MIIDA
MD - MARYLAND USE COUNTRY CODE IF MAKE CAN NOT BE DETERMINED
JQ - MASHANTUCKET PEQUOT TRIBE OF CONNECTICUT USE COUNTRY CODE IF MAKE CAN NOT BE DETERMINED
XT - MASHPEE WAMPANOAG TRIBE, MASSACHUSETTS USE COUNTRY CODE IF MAKE CANNOT BE DETERMINED
MSQ - MASQUELIER
MAM - MASSACHUSETTS ARMS CO.BRAND OF STEVENS
MA - MASSACHUSETTS USE COUNTRY CODE IF MAKE CAN NOT BE DETERMINED
MMA - MASTER MAG 12 GA SHOTGUN
MPA - MASTERPIECE ARMS, INC. CARROLLTON, GA
AYA - MATADOR SHOTGUN MODEL OF AYA
MHG - MATCH GUNS
MSS - MATCH MASTER MODEL OF M-S SAFARI ARMS
JS - MATCH-E-BE-NASH-SHE-WISH BAND OF POTTAWATOMI INDIANS OF MICHIGAN USE COUNTRY CODE IF MAKE CAN NOT BE DETERMINED
MTA - MATEBA PAVIA, IT
MHU - MATHIEU ARMS & DEVELOPMENT MFG OF RIFLES
MXA - MATRIX AEROSPACE CORPORATION; CLAREMONT, CONNECTICUT ADDED/ASSIGNED 2/26/14
MSN - MATSAN; ISTANBUL,TURKEY ; MAKER 0F DIAM0ND BRAND SH0TGUNS.D0 N0T C0NFUSE WITH ''HATSAN'' ALS0 FR0M ISTNBUL TURKEY
MU - MAURITANIA USE COUNTRY CODE IF MAKE CAN NOT BE DETERMINED
UM - MAURITIUS USE COUNTRY CODE IF MAKE CAN NOT BE DETERMINED
MAU - MAUSER (ARISTOCRAT RIFLE)
MRM - MAVERICK ARMSEAGLE PASS, TXDERRINGER MFD. BY UBERTI EAGLE PASS, TX
MVI - MAVI DI SALVINELLI
MXD - MAXIM DEFENSE INDUSTRIES LLC SAINT CLOUD, MN
MAX - MAXIM MACHINE GUNS
MXS - MAXIMUS ARMS LLC GALLATIN, TN
MXW - MAXWELL ARMSMFR. OF BLACK POWDER GUNS
GES - MAYDAY FLARE GUNMFD. BY GENRUS ENGINEERINGSPECIALTIES
MYR - MAYER & RIEM MFR OF STARTER GUNS
NHM - MAYER, N. H. (NHM) MFR.OF STARTER GUNS
MYD - MAYNARDMFR. OF CIVIL WAR RIFLES
MYS - MAYOR & SONS
Y0 - MAYOTTE, TERRITORIAL COLLECTIVITY OF USE COUNTRY CODE IF MAKE CAN NOT BE DETERMINED
MCB - MCBRIDE TACTICAL GUNWORKS INC OXNARD, CA
MCE - MCCLURE OUTDOOR (MCCLURE,KEVIN) LOWPOINT, IL
MCK - MCKAY ENTERPRISES, LLC MENDOTA HEIGHTS, MN
MCL - MCLAUGHLIN GUN MFG.
MLG - MCLEARN CUSTOM GUNS (MCLEARN,MATTHEW) CRIDERSVILLE, OHIO
MWR - MCWHORTER CUSTOM RIFLES DOERUN, GA
MMG - MEAN METAL GUNS INC. SPRING VALLEY, IL
MRS - MEARS MODEL OF SHOTGUN
MDU - MEDUSA FIREARMS (ALAN R. LAWRENCE) SPARKS, NEVADA
MGM - MEGA MACHINE SH0P INC AKA MEGA ARMS, LLC TURNWATER, WA
MSK - MEIJI SEIKA KAISHA
MIB - MEKANIKA INDUSTRIA E COMERCIO LTD
MEA - MELINA
RBR - MELOIR MFG BY ROBAR ET CIE
MDZ - MENDOZA
IX - MENOMINEE INDIAN TRIBE OF WISCONSIN USE COUNTRY CODE IF MAKE CAN NOT BE DETERMINED
MNT - MENTZ
MEY - MERCURY PISTOLS AND SHOTGUNS TRADEWINDS BRAND NAME
MER - MEREILLEUX
MCG - MEREX CORP. GEBRUDER DISTRIBUTOR SURPLUS WEAPONS
MEF - MERIDEN FIREARMS CO.SEARS SUBSIDIARY
MDC - MERIDIAN DEFENSE CORPORATION GOLETA, CALIFORNIA
MRC - MERILL CO.MFR. OF SINGLE-SHOT PISTOLS
MEE - MERKEL
MRR - MERRIMACK ARMS NEWBURYPORT, MA
MRN - MERRIMAN GUN & KNIFE WORKS (TRADE NAME); MERRIMAN STEEL & EQUIPMNT, INC.(LICENSE NAME) BEDFORD, IN
MEV - MERVEILLEUX REPEATING PISTOL
MEB - MERWIN & BRAY MFG OF CIVIL WAR RIFLES
MH - MERWIN & HUBERT (M & H) OR MARSHALL ISLANDS USE COUNTRY CODE IF MAKE CAN NOT BE DETERMINED
MPI - MESA PRECISION ARMS, INC. GRAND JUNCTION,COLORADO
JT - MESCALERO APACHE TRIBE OF THE MESCALERO RESERVATION, NEW MEXICO USE COUNTRY CODE IF MAKE CAN NOT BE DETERMINED
MET - METEOR RIFLES VARIOUS MFRS MODEL 52 MFD. BY STEVENS
JV - METLAKATLA INDIAN COMMUNITY, ANNETTE ISLAND ALASKA USE COUNTRY CODE IF MAKE CAN NOT BE DETERMINED
ML0 - METRILLO GUN CORPORATION,PHILIPPINES
MT0 - METRO ARMS CORPORATION, PARANQUE, PHILIPPINES _AMERICAN CLASSIC, AMERICAN CLASSIC II
MEC - MEXICAN MODEL
MM - MEXICO (SEE SEPARATE LIST OF MEXICAN STATES; USE CODE MM ONLY WHEN STATE IS UNKNOWN) USE COUNTRY CODE IF MAKE CAN NOT BE DETE
MX - MEXICO (STATE) USE COUNTRY CODE IF MAKE CAN NOT BE DETERMINED
MAJ - MFG. D'ARMES A FEU
MDF - MFR. D'ARMAS DE FUEGO
MGA - MG ARMS INC. SPRING, TX
MGS - MG INDUSTRIES INC. HERMAN, ME
MGD - MGI-MG INDUSTRIES INC BANGOR, ME (NOT THE SAME AS M GROUP INTERNATIONAL "INTL" DELTONA, FL)
MG0 - MGS HOLDINGS GROUP, LLC (MGS FIREARMS) MENOMONEE FALLS, WISCONSIN
DS - MIAMI TRIBE OF OKLAHOMA USE COUNTRY CODE IF MAKE CAN NOT BE DETERMINED
JW - MICCOUSUKEE TRIBE OF INDIANS, FLORIDA USE COUNTRY CODE IF MAKE CAN NOT BE DETERMINED
MMN - MICHAELS MACHINES; EDWARDSVILLE, ILLINOIS _(MACHINE GUNS)
MIH - MICHIGAN ARMAMENT
MI - MICHIGAN USE COUNTRY CODE IF MAKE CAN NOT BE DETERMINED
MC - MICHOACAN USE COUNTRY CODE IF MAKE CAN NOT BE DETERMINED
MI0 - MICRO FACTURE, LLC (MF2) MOUNTVILLE, PENNSYLVANIA
MMM - MICRO-MIGHT, INC. CASTLE, PENNSYLVANIA
MSR - MICROTECH SMALL ARMS RESEARCH; BRADFORD, PENNSYLVANIA
MIA - MIDLAND GUN CO.
MW - MIDWAY ISLANDS USE COUNTRY CODE IF MAKE CAN NOT BE DETERMINED
MWI - MIDWEST INDUSTRIES, INC. WAUKESHA, WISCONSIN
MPX - MIDWEST PX, LLC GRINNELL, IA
MIE - MIEG, ARMAND
MIG - MIGHTY MIDGET
MMK - MIKE'S GUN SALES AND SERVICE ARANSAS PASS, TEXAS
MKA - MIKKENGER ARMS
MII - MIL INCORPORATED PINEY FLATS, TN. NOT SAME AS MILI INC AKA MUNITIONS INTERNATIONAL LAB, INC. (MAK/MII)
MID - MILADY
MLI - MILI INC. AKA MUNITIONS INTERNATIONAL LAB INC. PINEY FLATS, TN ** NOT THE SMAE AS MIL, INC (MAK/MII) PINEY FLATS, TENNESSEE 
MIL - MILITARY AUTOMATIC
MPS - MILITARY POLICE SYSTEMS (AKA) MPS; PINEY FLATS, TN
MLK - MILKOR COMPANY; SOUTH AFRICA
LC - MILLE LACS BAND OF CHIPPEWA, MINNESOTA USE COUNTRY CODE IF MAKE CAN NOT BE DETERMINED
MLC - MILLER ARMS COMPANY INC DBA SUTTER'S FORT ARMORY SACRAMENTO, CALIFORNIA
MLP - MILLER PRECISION ARMS (ACUTECH, LLC) COLUMBIA FALLS, MONTANA
MCD - MILTAC INDUSTRIES, LLC MERIDIAN, ID
MIM - MINIMA
MIF - MINNEAPOLIS FIREARMS CO.
MNS - MINNESOTA ARMS CO.
XU - MINNESOTA CHIPPEWA TRIBE, MINNESOTA (SIX COMPONENT RESERVATIONBOIS FORTE BAND (NETT LAKE); FORD DU LAC BAND; GRAND PORTAGE BA
MN - MINNESOTA USE COUNTRY CODE IF MAKE CAN NOT BE DETERMINED
MTL - MINUTEMAN TACTICAL, LLC; SPRING LAKE, NORTH CAROLINA ADDED/ASSIGNED 1/22/15
JX - MISSISSIPPE BAND OF CHOCTAW INDIANS USE COUNTRY CODE IF MAKE CAN NOT BE DETERMINED
MIS - MISSISSIPPI VALLEY ARMS CO.VARIOUS MFRS.
M0 - MISSOURI USE COUNTRY CODE IF MAKE CAN NOT BE DETERMINED
MVA - MISSOURI VALLEY ARMS, LLC WASHINGTON, MISSOURI
MGL - MITCHEL-MOGAL IMPORTER
MTC - MITCHELL ARMS IMPORTED GUNS
MMT - MITCHELL MACHINE TOOL, LLC ROCHESTER, NY
MTM - MITCHELL MANUFACTURING C0RP0RATI0N; SANTA ANNA CALIF0RNIA
PCS - MITRAILLETTE VIGNERON MFG BY PRECISION LIEGEOISE S. A.
MKI - MK ARMS, INC.IRVINE, CA
MKX - MK SPECIALTIES; GRAFTON, WV
MKP - MKP ARMS, LLC MINCO, OK
MKS - MKS SUPPLY, INC.MANSFIELD, OHMFG/DIST FOR HASKELL, HIGH POINTIBERIA, AND STALLARD PISTOLS
MLS - MLS ARMS,LLC PHOENIX, AZ
MMR - MMC ARMORY (MENNIE MACHINE COMPANY, INC.) MARK, ILLINOIS
M0C - MOA CORPORATION BROOKVILLE OHIO
M0L - MOA RIFLES, LLC REDMOND, OREGON
MLL - MOA, LLC DITTMER, MISSOURI
XV - MOAPA BAND OF PAIUTE INDIANS OF THE MOAPA RIVER INDIAN RESERVATION NEVADA USE COUNTRY CODE IF MAKE CANNOT BE DETERMINE
SAV - MODEL B-63MODEL B-64MODEL B-65CMODEL B-68MODEL B-963MODEL B-967_SAVAGE
0RN - MODEL D'ORDONNANCE
MAE - MODELE DES ARMES
MML - MODERN MUZZLE LOADING, INC.HASTINGS, NB; MAKES MUZZLE LOADING,PRIMITIVE IGNITION, BLACK-POWDERIN-LINE RIFLE. WEAPON IS MARKE
M0F - MODERN OUTFITTERS, LLC; MERIDIAN, MISSISSIPPI _GUN-ADDED/ASSIGNED 9/9/15
MS - MODESTO SANTOS (MS)MFR. OF SHOTGUNS OR MISSISSIPPI USE COUNTRY CODE IF MAKE CAN NOT BE DETERMINED
XH - MODOC TRIBE OF OKLAHOMA USE COUNTRY CODE IF MAKE CANNOT BE DETERMINED
MKY - MOHAWK ARMORY; MIDWAY, TENNESSEE
XW - MOHEGAN INDIAN TRIBE OF CONNECTICUT USE COUNTRY CODE IF MAKE CANNOT BE DETERMINED
LD - MOLDOVA USE COUNTRY CODE IF MAKE CAN NOT BE DETERMINED
MJ - MONACO USE COUNTRY CODE IF MAKE CAN NOT BE DETERMINED
MND - MONDIAL (BLANK PISTOLS) MFR OF STARTER GUNS
M0G - MONDRAGON
M0N - MONETA-GUERNICA
MG - MONGOLIA USE COUNTRY CODE IF MAKE CAN NOT BE DETERMINED
M0T - MONITOR COMMERCIAL VERSION OF BAR, VARIOUS MFGRS
MMC - MONOMAC
MTR - MONTANA RIFLE COMPANY; KALISPELL, MT
M0B - MONTENEGRIN
XB - MONTENEGRO USE COUNTRY CODE IF MAKE CANNOT BE DETERMINED
RR - MONTSERRAT (DEPENDENT TERRITORY OF UNITED KINGDOM) USE COUNTRY CODE IF MAKE CAN NOT BE DETERMINED
MRD - MOORE ADVANCED DYNAMICS (BLACK DOG ARMORY LLC.) KANSAS CITY, KS
MMI - MOORE'S MACHINE COMPNAY, INC; SANFORD, NC
M00 - MOORE, WILLIAM, & CO.IMPORTED BY H & D FOLSOM
MR - MORELOS USE COUNTRY CODE IF MAKE CAN NOT BE DETERMINED
M0I - MORIARTI ARMAMENTS, LLC MIAMI, FLORIDA
MNI - MORINI COMPETITION ARMS BEDANO, SWITZERLAND
M0P - MORLEY & MURPHY HDW. CO.
MQ - MOROCCO USE COUNTRY CODE IF MAKE CAN NOT BE DETERMINED
M0R - MORRISBURG
MSY - MORRISSEY INC. BLOOMINGTON, MN
RHI - MORRONE MODEL OF RHODE ISLAND ARMS
M0A - MOSIN-NAGANTRUSSIAN MILITARY RIFLE
MCA - MOSSY CREEK ARMS, INC NASHVILLE,TENNESSEE
MCW - MOTOR CITY GUN WORKS AKA KEEGO TECH INC. HARBOR, MI
M0U - MOUNT STAR, INC. MONTEBELLO, CALIFORNIA
PCI - MOUNTAIN ARMS CO.MFR. OF PRECISION IND.
MCP - MOUNTAIN COMPETITION PISTOLS; TANNERSVILLE, PENNSYLVANIA
MT - MOUNTAINEER RIFLE REMANUFACTURED ENFIELD OR MONTANA USE COUNTRY CODE IF MAKE CANNOT BE DETERMINED
M0W - MOWERY GUN WORKS MFR OF PERCUSSION RIFLES
Z0 - MOZAMBIQUE USE COUNTRY CODE IF MAKE CAN NOT BE DETERMINED
PGG - MRM TRANS, LLC (PTGUNWORKS) WESTMINSTER, CALIFORNIA
MSA - MSA
M0V - MT. VERNON ARMS CO.IMPORTED BY H & D FOLSOM
MTS - MTS
JY - MUCKLESHOOT INDIAN TRIBE OF THE MUCKLESHOOT RESERVATION, WASHINGTON
MUL - MUELLER
DT - MUSCOGEE (CREEK) TRIBE OF OKLAHOMA USE COUNTRY CODE IF MAKE CAN NOT BE DETERMINED
MGV - MUSGRAVE MFG OF RIFLES
MUK - MUSKETEER RIFLE-MODEL OF F.I. GARCIA
MUS - MUSTANG MARSHALS SERVICE, LTD., RENO, NEVADA
MVB - MVB INDUSTRIES INC. DEERFIELD BEACH, FL
NJD - N.J.D. TACOMA, WA
NAG - NAGANT (REVOLVERS)
NMP - NAMBU (PISTOLS)MILITARY WEAPONS
SJ - NAMIBIA (SOUTH-WEST AFRICA) USE COUNTRY CODE IF MAKE CAN NOT BE DETERMINED
NAN - NANIWA KOGYO K. K. MFR OF SHOTGUNS
RYN - NAPOLEON MFG BY RYAN
NJS - NARAIN JAGANNATH SIKLIGAR UDAIPUR (N.J.S. UDAIPUR) INDIA
NAH - NAROH ARMS, INC. ROCKLEDGE, FLORIDA
NAS - NASHVILLE ARMS
NAL - NATIONAL ARMORY, LLC POMPANO BEACH, FLORIDA
NTM - NATIONAL MILITARY ARMAMENT, LLC (NATMIL) VAN BUREN, ARKANSAS
N0I - NATIONAL ORDNANCE, INC.MFR. OF RIFLES
NSP - NATIONAL SPORTS PRODUCTS
NML - NATMIL TK/UZKON (BORA ARMS) TURKEY
JZ - NATTAGANSETT INDIAN TRIBE OF RHODE ISLAND USE COUNTRY CODE IF MAKE CAN NOT BE DETERMINED
NR - NAURA USE COUNTRY CODE IF MAKE CAN NOT BE DETERMINED
KD - NAVAJO NATION, ARIZONA, NEW MEXICO AND UTAH USE COUNTRY CODE IF MAKE CAN NOT BE DETERMINED
NVL - NAVAL COMPANY
NAV - NAVAL COMPANY, INC.DOYLESTOWN, PAUSE NVL ONLY WHEN MODEL IS OTHER THAN LISTED
NA - NAYARIT USE COUNTRY CODE IF MAKE CAN NOT BE DETERMINED.
NBN - NB I.N.A.T. KRAGUJEVAC, SERBIA
EYA - NCM ENTERPRISES, LLC DBA-ELYSIUM ARMAMENT TRAVERSE CITY, MIADDED/ASSIGNED 1/21/16
NCP - NCP PRODUCTS, INC.; CANTON, OH MAKER OF MACH 1 SHOTGUN CROSS REFERENCEWITH MACH 1 FOR CODE PURPOSES
NB - NEBRASKA USE COUNTRY CODE IF MAKE CAN N0T BE DETERMINED
NBU - NEBULOUS ORDNANCE, LLC; MIAMI, FLORIDA
NEJ - NED. MAGAZIJI
NMA - NEMESIS ARMS INC. CALIMESA, CA.
NE0 - NEMO ARMS, INC KALISPELL, MONTANA
NEM - NEMROD
NP - NEPAL USE COUNTRY CODE IF MAKE CAN NOT BE DETERMINED
RUP - NERO MFD BY RUPERTUS
NES - NESIKA BAY PRECISION, INC. POULSBO, WA
NV - NEVADA USE COUNTRY CODE IF MAKE CAN NOT BE DETERMINED
NEG - NEVER ENOUGH GUNS (NEG-HANKES, BRET A.) SLAYDEN, TENNESSEE
NBG - NEW BEGINNING CONSTRUCTION (GUN WORKS), LLC SPRINGER,NEW MEXICO
NK - NEW BRUNSWICK USE COUNTRY CODE IF MAKE CAN NOT BE DETERMINED
NQ - NEW CALEDONIA & DEPENDENCIES, TERRITORY OF (FRENCH OVERSEAS TERRITORY) USE COUNTRY CODE IF MAKE CAN NOT BE DETERMINED
NEC - NEW CAROLINA MODEL OF SHOTGUN
NEI - NEW EMPIRE BRAND NAME OF VARIOUS MANUFACTURERS
NEE - NEW ENGLAND ARMS CO.
NEF - NEW ENGLAND FIREARMS GARDNER,MASSACHUSETTS TOOK OVER HARRINGTON & RICHARDSON
NWT - NEW ENGLAND WESTINGHOUSE/REMINGTON
NFR - NEW FRONTIER ARMORY, LLC NORTH LAS VEGAS, NEVADA
NH - NEW HAMPSHIRE USE COUNTRY CODE IF MAKE CANNOT BE DETERMINED
NJ - NEW JERSEY USE COUNTRY CODE IF MAKE CAN NOT BE DETERMINED
NEL - NEW LIBERTY
NM - NEW MEXICO USE COUNTRY CODE IF MAKE CAN NOT BE DETERMINED
NY - NEW YORK USE COUNTRY CODE IF MAKE CAN NOT BE DETERMINED
NZ - NEW ZEALAND USE COUNTRY CODE IF MAKE CAN NOT BE DETERMINED
NF - NEWFOUNDLAND (INCLUDES LABRADOR) USE COUNTRY CODE IF MAKE CAN NOT BE DETERMINED
NEB - NEWMAN BROTHERS DOUBLE SHOTGUNS
NEP - NEWPORT
NEW - NEWTON
NEN - NEWTON ARMS CO.
NWN - NEWTOWN FIREARMS PLACERVILLE, CA.
NGA - NEXT GENERATION ARMS, TOLEDO, OREGON
NXL - NEXT LEVEL ARMAMENT/MFG'ING, LLC JENISON, MICHIGAN
KF - NEZ PERCE TRIBE, IDAHO (FORMERLY LISTED NEZ PERCE TRIBE OF IDAHO) USE COUNTRY CODE IF MAKE CAN NOT BE DETERMINED
NU - NICARAGUA USE COUNTRY CODE IF MAKE CAN NOT BE DETERMINED
NMI - NICHOLS MANUFACTURING, INC. (THE GUN COMPANY) MILPITAS, CALIFORNIA
NN - NIGER USE COUNTRY CODE IF MAKE CAN NOT BE DETERMINED
NG - NIGERIA USE COUNTRY CODE IF MAKE CAN NOT BE DETERMINED
NHK - NIGHTHAWK CUSTOM; BERRYVILLE, ARKANSAS
NTK - NIGHTHAWK FIREARMS LORIDA, FL MFRS M-10 TYPE SEMI-AUTOMATIC FRAMES
NJK - NIHON JUHO KOGYOSHO MFGR OD SHOTGUNS
NYC - NIPPON YUKI CO., LTD.MFR. OF SHOTGUNS
KG - NISQUALLY INDIAN TRIBE OF THE NISQUALLY RESERVATION, WASHINGTON USE COUNTRY CODE IF MAKE CAN NOT BE DETERMINED
NTS - NITESCOUT, LLC; WATERBURY, CONNECTICUT
IU - NIUE USE COUNTRY CODE IF MAKE CAN NOT BE DETERMINED
NIV - NIVA
ZAB - NOC-A-BOT MFG BY ZABALA HERMANOS
NDK - NODAK ARMS, INC. (NOT TO BE CONFUSED WITH NODAK SPUD, LLC) MINOT, NORTH DAKOTA
NDS - NODAK SPUD; BLAINE, MINNESOTA
NMD - NOMAD DEFENSE COMPANY, INC LAKE HAVASU CITY, AZ
NRL - NON-RAYE BRAND OF SHOTGUNS
KJ - NOOKSACK INDIAN TRIBE OF WASHINGTON USE COUNTRY CODE IF MAKE CAN NOT BE DETERMINED
N0W - NOPWICH ARMS
N0D - NORDHEIM ALSO USES NAME OF VONO
NRD - NORDIC COMPONENTS INC. WACONIA, MN
NRN - NOREEN FIREARMS, LLC BELGRADE, MT
0F - NORFOLK ISLAND, TERRITORY OF (AUSTRALIAN EXTERNAL TERRITORY) USE COUNTRY CODE IF MAKE CAN NOT BE DETERMINED
NVS - NORFOLK, VIRGINIA SHOTGUNS, INPORTER ONLY
NRC - NORICA MFG BY NORBERTO ARIZMENDI
N0N - NORINCO
N0M - NORMA
NMR - NORRAHAMMAR MFGR OF RIFLES
NSC - NORRIS & CLEMENT MFR OF CIVIL WAR RIFLES
N0H - NORTH & SAVAGE
NRB - NORTH AMERICA ARMS, CORP, TORONTO CANADA (NOT SAME AS: NORTH AMERICAN ARMS CORP;QUEBEC CANADA)
NRA - NORTH AMERICAN ARMS CO.LTD.(QUEBEC CANADA)ALSO A NORTH AMERAMERICANS ARMS CO IN THE U.S. MAK/NAA) THEY ARE (2) DIFFERENT COM
NAA - NORTH AMERICAN ARMS MFG OF .225 SINGLE-SHOT DERRINGER
NC - NORTH CAROLINA USE COUNTRY CODE IF MAKE CAN NOT BE DETERMINED
NTC - NORTH COUNTY SHOOTING CENTER, INC. (NORTH COUNTY FIREARMS) SAN MARCOS, CA
ND - NORTH DAKOTA USE COUNTRY CODE IF MAKE CAN NOT BE DETERMINED
NFA - NORTH FULTON ARMS LAWRENCEVILLE,GA
NI - NORTH IRELAND OR UN FOR UNITED KINGDOM USE COUNTRY CODE IF MAKE CANNOT BE DETERMINED
KN - NORTH KOREA USE COUNTRY CODE IF MAKE CAN NOT BE DETERMINED
N0S - NORTH, SIMEON CARBINES
KL - NORTHERN CHEYENNE TRIBE OF THE NORTHERN CHEYENNE INDIAN RESERVATION, MONTANA USE COUNTRY CODE IF MAKE CAN NOT BE DETERMINED
NTD - NORTHTECH DEFENSE HUBBARD, OR
NT - NORTHWEST TERRITORIES USE COUNTRY CODE IF MAKE CAN NOT BE DETERMINED
YZ - NORTHWESTERN BAND OF SHOSHONI NATION UTAH (WASHAKIE) USE CODE CODE IF MAKE IS NOT AVAILABLE
NW - NORWAY USE COUTNRY CODE IF MAKE CAN NOT BE DETERMINED
N0L - NORWICH LOCK MFG. CO.
NSR - NOSLER INC, BEND, OREGON
N0T - NOT NAC MFG. CO.MFD. BY CRESCENT
KM - NOTTAWASEPPI HURON BAND OF THE POTAWATOMI, MICHIGAN (FORMERLY THE HURON POTAWATOMI, INC.) USE COUNTRY CODE IF MAKE CAN NOT BE
NSS - NOUS DEFIONS, LLC FREEPORT, FLORIDA
N0U - NOUVEAU
NS - NOVA SCOTIA USE COUNTRY CODE IF MAKE CAN NOT BE DETERMINED
N0V - NOVAMATIC
NVK - NOVESKE RIFLE WORKS LLC; GRANTS PASS, OREGON
NCM - NOWLIN CUSTOM MFG. CLAREMORE,OK
N0Y - NOYO
NSF - NSF CUSTOMS GUNS/NSF LLC/NINE SEVEN FIREARMS LLC, PITTSBURGH,PA
NAC - NU ARM CO. LTD. STATEN ISLAND, NEW YORK
NL - NUEVO LEON USE COUNTRY CODE IF MAKE CAN NOT BE DETERMINED
NUM - NUMRICH ARMS CORP.
XN - NUNAVUT TERRITORY USE COUNTRY CODE IF MAKE CANNOT BE DETERMINED NUVAVUT
NUR - NUR OTOMOTIV TEKSTIL SILAH KONYA, TURKEY
0BI - O'BRIEN RIFLE CO.
0DI - O. D. I., INCORPORATED MIDDLEPARK, NJ
OEM - OEM TECHNOLOGIES, LLC (OEM WEAPONS & SUPPLY) APPLETON,WI
0WA - O. W. A.
0AK - OAK LEAF VARIOUS MFRS
0A - OAXACA USE COUNTRY CODE IF MAKE CAN NOT BE DETERMINED
0BR - OBREGON
0AC - ODDITY ARMS CO.MFR. OF KNIFE PISTOLS
0S - OGLALA SIOUX OF PINE RIDGE RESERVATION, SOUTH DAKOTA USE COUNTRY CODE IF MAKE CAN NOT BE DETERMINED
00W - OHIO ORDNANCE; CHARDON, OHIO
0H - OHIO USE COUNTRY CODE IF MAKE CANNOT BE DETERMINED
KQ - OHKAY OWINGEH, NEW MEXICO (FORMERLY THE PUEBLO OF SAN JUAN) USE COUNTRY CODE IF MAKE CAN NOT BE DETERMINED
0I - OKINAWA USE COUNTRY CODE IF MAKE CAN NOT BE DETERMINED
0K - OKLAHOMA USE COUNTRY CODE IF MAKE CANNOT BE DETERMINED
0GG - OLD GLORY GUNS AND AMMO, LLC MASON, NH
SHB - OLD RELIABLE MARKING ON SHARPS BORCHARDT RIFLES
0LL - OLIVER ARMS, LLC SPARTANBURG,SC
0WW - OLIVER WEAPON WORKS, LLC GILBER, AZ
0LY - OLYMPIA PISTOLE
0LP - OLYMPIC BRAND OF VARIOUS MFGRS
0M - OM BRAND OF OJANGUREN Y MARCAIDE OR OMAN USE COUNTRY CODE IF MAKE CAN NOT BE DETERMINED
KX - OMAHA TRIBE OF NEBRASKA USE COUNTRY CODE IF MAKE CAN NOT BE DETERMINED
0MC - OMC "BACK UP"
0ME - OMEGA (HANDGUNS)IMPORTER OF HANDGUNS FROM SPAIN,ITALY,AND GERMANY
0AR - OMEGA ARMS; ALLENDALE, MICHIGAN
0TK - OMEGA SILAH VE TUFEK SANAYI TICARET LTD.STI (TURKEY)
0MN - OMNI ARMS, LLC ALBUQUERQUE, NEW MEXICO
0SA - ON SITE ARMORY NILES, MICHIGAN PERFORMANCE MACHINING INC
0TA - ON TARGET TACTICAL SUPPLY WOLFE CITY, TEXAS
0NA - ONANDIA
0Z - ONEIDA NATION OF NEW YORK USE COUNTRY CODE IF MAKE CANNOT BE DETERMINED
0T - ONEIDA TRIBE OF INDIANS OF WISCONSIN USE COUNTRY CODE IF MAKE CANNOT BE DETERMINED
NLF - ONETIME UNLIMITED, LLC (NEWLEAF FIREARMS) WESTBORO, WISCONSIN
LG - ONONDAGA NATION OF NEW YORK USE COUNTRY CODE IF MAKE CAN NOT BE DETERMINED
0N - ONTARIO USE COUNTRY CODE IF MAKE CANNOT BE DETERMINED
OSD - OPEN SEASON DEFENSE, LLC GLENDALE, ARIZONA
00P - OPERATOR OUTPOST, LLC SPRING BRANCH, TEXAS
0PS - OPS INC. BROWNS VALLEY, CALIFORNIA
0CF - ORANGE COUNTY FIREARMS FOUNTAIN VALLEY, CA
0RC - ORCA ARMS, LLC SAN DIEGO, CA
0RD - ORDINANZA
0DC - ORDNANCE DESIGN CO.
0TY - ORDNANCE TECHNOLOGY; STETSON, ME
0AL - OREGON ARMS LIMITED PROSPECT, OR
0RI - OREGON ARMS, INC; PROSPECT,OR. NOT TO BE CONFUSED WITH OREGON ARMS LIMITED ALSO IN PROSPECT, OR
0R - OREGON USE COUNTRY CODE IF MAKE CANNOT BE DETERMINED
0RK - ORISKANY ARMS, INC. ORISKANY, NEW YORK
0G - OSAGE NATION OF OKLAHOMA USE COUNTY CODE IF MAKE CAN NOT BE DETERMINED
0SC - OSCILANTE-AZUL
0SG - OSGOOD GUN WORKS
0SM - OSMUN ARMORY,LLC ANDERSON,MO
0SP - OSPREY
0SS - OSS SUPPRESSORS LLC%MILLCREEK UTAH
0ST - OSTENEICHISHA
0TE - OTERR-STERR
SMM - OTIS A. SMITH
00 - OTOE-MISSOURIA TRIBE OF INDIANS OF OKLAHOMA USE COUNTRY CODE IF MAKE CANNOT BE DETERMINED
0T0 - OTTAWA ORDNANCE OTTAWA, OHIO
XI - OTTAWA TRIBE OF OKLAHOMA USE COUNTRY CODE IF MAKE CANNOT BE DETERMINED
0TT - OTTOMANGUNS TURKEY
00D - OUTBREAK ORDNANCE LLC BIG PINE KEY, FL
0GM - OUTLAW GUNS AND AMMO, LLC LEAGUE CITY, TEXAS
0UT - OUTLAW PRECISION WEAPONRY, LLC ALMONT, MICHIGAN
0WN - OWEN SUBMACHINE GUNS
OZK - OZARK GUN & PAWN,LLC (SHEPHERD ARMORY) VERSAILLES,MO
0YE - OYEZ
LXG - P & C MACHINE CO INC. DBA LANXANG TACTICAL / LT CONYERS, GA
PMM - P.M. MACHINE COMPANY (VLH INC.) BERRYVILLE, ARKANSAS
PAI - PAC (PACIFIC ARMS CO.)IMPORTER ONLY
PCH - PACHMAYR GUN WORKS
PIM - PACIFIC INTERNATIONAL; DISTRIBUTOR
PAD - PADRE
PAG - PAGE-LEWIS
PA0 - PAGOMA
PWZ - PAINT WERKZ, LLC PHOENIX, ARIZONA
XZ - PAIUTE INDIAN TRIBE OF UTAH (CEDAR BAND OF PAIUTES, KANOSH BAND OF PAIUTES, KOOSHAREM BAND OF PAIUTES, INDIAN PEAKS BAND OF P
FV - PAIUTE-SHOSHONE TRIBE OF THE FALLON RESERVATION AND COLONY, NEVADA USE COUNTRY CODE IF MAKE CAN NOT BE DETERMINED
PAK - PAKISTAN ORDNANCE FACTORIES; PAKISTAN
PK - PAKISTAN USE COUNTRY CODE IF MAKE CAN NOT BE DETERMINED
PD - PALAU, REPUBLIC OF USE COUNTRY CODE IF MAKE CAN NOT BE DETERMINED
PT0 - PALESE PROTO TECH INC DBA PROTO TECH,TUCSON, AZ
PM0 - PALMER ORDNANCE LLC SEABECK, WA
PMT - PALMETTO ITALY
PLM - PALMETTO MARKING ON TRYON RIFLES
PAA - PALMETTO STATE ARMORY WEST COLUMBIA, SC
PSD - PALMETTO STATE DEFENSE GREER, SC
PL - PALMYRA ATOLL USE COUNTRY CODE IF MAKE CAN NOT BE DETERMINED
PM - PANAMA USE COUNTRY CODE IF MAKE CAN NOT BE DETERMINED
PTE - PANTERAN SPORTING ARMS BEYSEHIR,KONYA, TURKEY
PZR - PANZER ARMS TURKEY
N0 - PAPUA NEW GUINEA (FORMERLY NEW GUINEA) USE COUNTRY CODE IF MAKE CAN NOT BE DETERMINED
PAC - PAR & CASE
P0D - PARA ORDNANCE (HALTED PRODUCTION IN CANADA) MOVED OPERATIONS TO US AND IS NOW "PARA USA, INC" PER MICHELE ATF TRACING 9/2/09
PBL - PARABELLUM ARMAMENT CO., LLC GROVE CITY, OHIO
PCB - PARABELLUM COMBAT SYSTEMS STILLWELL, OK
PAL - PARAGA
PAQ - PARAGON
PRN - PARAGON BRAND OF STEVENS AND HOPKINS & ALLEN
PAM - PARAMOUNT MADE BY SPADOZO APAOLOZO OR RETOLAZA
PV - PARAQUAY USE COUNTRY CODE IF MAKE CAN NOT BE DETERMINED
PRX - PARATUS-X, LLC (PARATUS ARMORY X) ENTIAT, WASHINGTON
PF - PARCEL ISLANDS USE COUNTRY CODE IF MAKE CAN NOT BE DETERMINED
PRD - PARDINI IMPORTED BY FIOCCHI
PRU - PARDUS SAVUNMA VE AV SANAYI (PARDUS ARMS) ISTANBUL, TURKEY
PBM - PARKER BROS. MAKERS, INC. MERIDEN, CONNECTICUT
PKD - PARKER REPRODUCTION, JAPAN
PAR - PARKER/PARKER BROS.MFR. OF SHOTGUNS
PAS - PARKHURST, WILLIAM
PKR - PARKINGTON & RICHARDSON
PDA - PASADENA FIREARMS IMPORTER
LJ - PASCUA UAQUI TRIBE OF ARIZONA USE COUNTRY CODE IF MAKE CAN NOT BE DETERMINED
PSP - PASPER S.R.L. ARGENTINA
LK - PASSAMAQUODDY TRIBE OF MAINE USE COUNTRY CODE IF MAKE CAN NOT BE DETERMINED
PTZ - PASTUSEK INDUSTRIES, INC. FORT WORTH, TEXAS
PAP - PATRIOT ARMS (PERRY R. GUY) HOLLY SPRINGS, MISSISSIPPI
PTA - PATRIOT DEFENSE ARMS, LLC; MEMPHIS, TENNESSEE
PRT - PATRIOT MANUFACTURER OF PARTISAN AVENGERT MFG BY BLISS & GOODYEAR
P0F - PATRIOT ORDNANCE U.S.A. (DBA) DOING BUSINESS AS POF
PTU - PATRIOT TACTICAL USA, LLC (PATRIOT RIFLEWORKS) JACKSONVILLE, FLORIDA
PAT - PATTERSON MACHINE DECATUR, TX
PW - PAWNEE TRIBE OF OKLAHOMA USE COUNTRY CODE IF MAKE CAN NOT BE DETERMINED
PAW - PAWS ADDITIONAL INFORMATION, SEE POLICE AUTOMATIC WEAPONS SERVICE
PG - PAXTON & GALLEGHER (P & G) OR GUINEA-BISSAU (FORMERLY PORTUGUESE GUINEA USE COUNTRY CODE IF MAKE CAN NOT BE DETERMINED
PED - PEDERSOLI MFG. ANTIQUE, MUZZLE LOADING PERCUSSION WEAPONS
PAZ - PEDRO ARRIZABALAGO; SPAIN
PGA - PEGASUS HOLDINGS GROUP, IRVINE,CA
PEL - PELICAN TRADEMARK OF OLGILVIE HARDWARE
PEN - PENGUIN MFR OF TEAR GAS GUNS AND DISTRESS SIGNALS
PNA - PENN ARMS PUNXSUTAWNEY, PS MFG OF STRIKER SHOTGUNS (CLASSIFIEDAS DESTRUCTUVE DEVICE)
PUT - PENN UNITED TECHNOLOGIES, CABOT, PA (MAKES FRAMES FOR CABOT GUNS, THEY ARE MFG OF RECORD FOR CABOT GUNS
PA - PENNSYLVANIA USE COUNTRY CODE IF MAKE CAN NOT BE DETERMINED
LM - PENOBSCOT TRIBE OF MAINE USE COUNTRY CODE IF MAKE CAN NOT BE DETERMINED
XJ - PEORIA TRIBE OF OKLAHOMA USE COUNTRY CODE IF MAKE CANNOT BE DETERMINED
PE0 - PEOTE
PRZ - PERAZZI MFGR OF SHOTGUNS
PND - PEREGRINE INDUSTRIES HUNTINGTON BEACH, CA
PEC - PERFECT
PRF - PERFECTA MFR OF STARTER PISTOLS
PTI - PERFECTTURNING INC.(DBA-AUTOLOCK INDUSTRIES) KIMBALL, NB FIREARMS ARE MARKED-PTI KIMBALL NE
PFR - PERFORMANCE ARMAMENT CORP, PEMBROKE PARK, FLORIDA
PEI - PERRIN
PDS - PERSONAL DEFENSE SYSTEMS LLC HOPKINSVILLE, KY
PU - PERU USE COUNTRY CODE IF MAKE CAN NOT BE DETERMINED
PGI - PERUGINI VISINI; BRESCIA, ITALY
PSG - PETER STAHL PADERBORN, GERMANY
PGW - PGW; P0WERS, 0REG0N
PHF - PHASE 5 TACTICAL (PHASE 5 WEAPONS SYSTEMS INC) ROSEVILLE, CA UPDATED PER ATF 10/7/14
PMF - PHELPS MANUFACTURING, CO. EVANSVILLE, IN
PI - PHILIPPINES USE COUNTRY CODE IF MAKE CAN NOT BE DETERMINED
PHR - PHILLIP AND ROGERS
RPC - PHILLIP CLAY ROETTINGER MFGR OF RIFLES
PHE - PHOENIX ARMS CO.MFR. OF PISTOLS
PXT - PHOENIX TRINITY MANUFACTURING INC. DAYTON, OH
PXW - PHOENIX WEAPONRY, LLC LONGMONT, CO
PHX - PHX PHOENIX AG INTERLAKEN, SWITZERLAND
PCY - PICKLER COMPREHENSIVE SECURITY, LLC; ARLINGTON, TENNESSEE
PRC - PIERCE ENGINEERING, LTD; LANSING, MICHIGAN
PIA - PIONEER ARMS CORPORATION; RADOM, POLAND
PTF - PIRLOT/PIRLOT FRERES
PTD - PISTOL DYNAMICS PALM BAY, FL
PMD - PISTOLE M. 37 OR M.29 MILITARY PISTOL
PME - PISTOLE MODELL 27 MILITARY PISTOL
SYS - PISTOLET AUTO. FRANCAIS UNION MFD BY SEYTRES
PKI - PJK,INC.BRADBURY,CA (DO NOT CONFUSE WITH (PJK-FEG IN HUNGARY
PMC - PLAINFIELD MACHINE CO.MFR.OF COMMERICIAL M1 CARBINES
PLA - PLANT'S MFG. CO.
PLN - PLANTATION ARMORY, LLC SUNRISE, FL
PKK - PLINKER ARMS, LLC (PLINKER TACTICAL) CORNELIUS, NC
PCF - PLUM CRAZY FIREARMS; LAKE HAVASU, ARIZONA
PLY - PLYMOUTH VARIOUS MFRS
PDI - PNEU-DART,INC.TRANQUILIZER GUNS
LQ - POARCH BAND OF CREEK INDIANS OF ALABAMA USE COUNTRY CODE IF MAKE CAN NOT BE DETERMINED
LR - POKAGON BAND OF POTAWATOMI INDIANS, MICHIGAN AND INDIANA USE COUNTRY CODE IF MAKE CAN NOT BE DETERMINED
P0I - POLAIN, PROSPER
P0 - POLAND USE COUNTRY CODE IF MAKE CAN NOT BE DETERMINED
P0C - POLICE ORDNANCE CO.(MACHINE GUN
P0R - POLYMER80, INC. (P80 TACTICAL P80) DAYTON, NEVADA
P0T - POLYTECHNOLOGIES
P0M - POMPEYA
PN - PONCA TRIBE OF INDIANS OF OKLAHOMA USE COUNRY CODE IF MAKE CAN NOT BE DETERMINED
YB - PONCA TRIBE OF NEBRASKA USE COUNTRY CODE IF MAKE CAN NOT BE DETERMINED
P0Y - PONY
PLE - POOLE, WM.J. (POOLE'S, AZ CUSTOM FIREARMS) WICKENBURG, AZ
LV - PORT GAMBLE OF INDIAN COMMUNITY OF THE PORT GAMBLE RESERVATION, WASHINGTON USE COUNTRY CODE IF MAKE CAN NOT BE DETERMINED
PT - PORTUGAL USE COUNTRY CODE IF MAKE CAN NOT BE DETERMINED
P0S - POS (PRIDE OF SPAIN) MFG OF SHOTGUNS
P0H - POWDER HORN
P0W - POWELL
PKP - POWELL KNIFE/PISTOL CO.TUSCON,AZ,MF'S PKP KNIFE-PISTOL
PWR - POWER SHOT, LLC LAURENS, SOUTH CAROLINA
P0X - POWERMAG IMPORTED BY HERTER, VARIOUS MFGRS
PPI - PPI DUCKTOWN,TN MFG OF POCKET PAL
PTT - PRACTICAL TACTICAL AR PARTS, LLC (P-TAC) WEST COLUMBIA, SC
PST - PRAESTOLOR ARMS, LLC ODESSA,FLORIDA
LW - PRAIRIE BAND OF POTAWATOMI NATION, KANSAS USE COUNTRY CODE IF MAKE CAN NOT BE DETERMINED
YD - PRAIRIE ISLAND INDIAN COMMUNITY IN THE STATE OF MINNESOTA USE COUNTRY CODE IF MAKE CAN NOT BE DETERMINED
PGL - PRECISION GUNCRAFT, LLC; MERIDIAN, IDAHO
PMP - PRECISION MACHINED PARTS, INC. NEVADA, MO
P0P - PRECISION POINT FIREARMS, LLC WOBURN, MASSACHUSETTS
PRI - PRECISION REFLEX INC AKA PRI NEW BREMEN, OHIO
PES - PRECISION SMALL PARTS (PSP)CHARLOTTESVILLE, VA; MFG. OF PSP-25
PLL - PRECISION TACTICAL ARMS CO., LLC CRESTVIEW, FLORIDA
PTY - PRECISION TECHNOLOGIES, LLC (ANGOLA,IN)
PDC - PREDATOR CUSTOM SHOP KNOXVILLE, TN
PTL - PREDATOR TACTICAL, LLC TEMPE, ARIZONA
PTG - PREDATOR TECHNOLOGY GROUP, LLC PHOENIX, ARIZONA
URI - PREMIER MFD BY TOMAS DE URIZAR Y CIA
PMR - PREMIER,MFG OF SHOTGUNS
PAF - PRETORIA ARMS FACTORY PRETORIA S.AFRICA MF'S PAFUNIOR" (FORMERLY RETIRED CODE)
PDE - PRICE DESIGN & ENGINEERING OAKDALE, CALIFORNIA
PRM - PRIMA
PWS - PRIMARY WEAPON SYSTEMS (DBA-PWS) BOISE, IDAHO
PE - PRINCE EDWARD ISLAND USE COUNTRY CODE IF MAKE CAN NOT BE DETERMINED
PNC - PRINCE- VARIOUS MFGRS
PRA - PRK ARMS; FRESNO CALIFORNIA
PRL - PROFESSIONAL ORDNANCE ONTARIO CANADA MFGR OF POLYMER FRAMES AND ARMS
PRG - PROGRESS
PGU - PROJECT GUNS, LLC BOCA RATON, FLORIDA
P00 - PROOF RESEARCH, INC. COLUMBIA FALLS, MT
PRR - PROTECTOR ARMS CO.
PR0 - PROTECTOR-VARIOUS MFGRS IN SPAIN AND U.S.
PPP - PROVOST'S PRECISION PISTOL, LLC.(TRADE NAME-P3 LLC; MARKEDON WEAPONS) WEATOGUE, CONNECTICUT
PDD - PT PINDAD INDONESIA
PTC - PTR-91 INC,FARMINGTON, CONNECTICUT BAUGHT JLD ENTERPRISES (MAK/JLD) MAKING SAME WEAPONS
PB - PUEBLA USE COUNTRY CODE IF MAKE CAN NOT BE DETERMINED
LZ - PUEBLO OF ACOMA, NEW MEXICO USE COUNTRY CODE IF MAKE CAN NOT BE DETERMINED
0B - PUEBLO OF COCHITI, NEW MEXICO USE COUNTRY CODE IF MAKE CANNOT BE DETERMINED
0D - PUEBLO OF ISLETA, NEW MEXICO USE COUNTRY CODE IF MAKE CAN NOT BE DETERMINED
0E - PUEBLO OF JEMEZ, NEW MEXICO USE COUNTRY CODE IF MAKE CAN NOT BE DETERMINED
0J - PUEBLO OF LAGUNA, NEW MEXICO USE COUNTRY CODE IF MAKE CANNOT BE DETERMINED
0L - PUEBLO OF NAMBE, NEW MEXICO USE COUNTRY CODE IF MAKE CAN NOT BE DETERMINED
0P - PUEBLO OF PICURIS, NEW MEXICO USE COUNTRY CODE IF MAKE CANNOTBE DETERMINED
YF - PUEBLO OF POJOAQUE, NEW MEXICO USE COUNTRY CODE IF MAKE CANNOTBE DETERMINED
0Q - PUEBLO OF SAN FELIPE, NEW MEXICO USE COUNTRY CODE IF MAKE CANNOPT BE DETERMINED
0U - PUEBLO OF SAN ILDEFONSO, NEW MEXICO USE COUNTRY CODE IF MAKE CAN NOT BE DETERMINED
0V - PUEBLO OF SANDIA, NEW MEXICO USE COUNTRY CODE IF MAKE CAN NOT BE DETERMINED
0W - PUEBLO OF SANTA ANA, NEW MEXICO USE COUNTRY CODE IF MAKE CAN NOT BE DETERMINED
0X - PUEBLO OF SANTA CLARA, NEW MEXICO USE COUNTRY CODE IF MAKE CAN NOT BE DETERMINED
PH - PUEBLO OF TAOS, NEW MEXICO USE COUNTRY CODE IF MAKE CAN NOT BE DETERMINED
PJ - PUEBLO OF TESUQUE, NEW MEXICO USE COUNTRY CODE IF MAKE CAN NOT BE DETERMINED
PP - PUEBLO OF ZIA, NEW MEXICO USE COUNTRY CODE IF MAKE CAN NOT BE DETERMINED
PX - PUEBLO OF ZUNI, NEW MEXICO USE COUNTRY CODE IF MAKE CAN NOT BE DETERMINED
PR - PUERTO RICO USE COUNTRY CODE IF MAKE CAN NOT BE DETERMINED
PUP - PUPPY SPANISH MFG,WAS FRANCISCO ARIZMENDI AND VARIOUS OTHER MANUFACTURERS
PY - PUYALLUP TRIBE OF THE PUYALLUP RESERVATION, WASHINGTON USE COUNTRY CODE IF MAKE CAN NOT BE DETERMINED
PWA - PWA (PACK WEST ARMS) MFD IN MILAN, ILLINOIS AND ASSEMBLED SPOKANE,WASHINGTON
PZ - PYRAMID LAKE PAIUTE TRIBE OF THE PYRAMID LAKE RESERVATION, NEVADA USE COUNTRY CODE IF MAKE CAN NOT BE DETERMINED
PZK - PZK
QLL - Q, LLC PORTSMOUTH, NEW HAMPSHIRE
QA - QATAR USE COUNTRY CODE IF MAKE CAN NOT BE DETERMINED
QLF - QUALIFIED MANUFACTURING; BROKEN ARROW, OKLAHOMA
QAI - QUALITY ARMS IDAHO, LLC RIGBY, IDAHO
QFI - QUALITY FIREARMS, INC.BOUGHT BY HERITAGE FIREARMS MFG OPALOCKA, FL MAK/HRT
QUA - QUAN-DOI CAO-DAI MILITARY WEAPONS
XK - QUAPAW TRIBE OF OKLAHOMA USE COUNTRY CODE IF MAKE CANNOT BE DETERMINED
QCR - QUARTER CIRCLE 10 (QC10) TUCSON, ARIZONA
PQ - QUEBEC USE COUNTRY CODE IF MAKE CAN NOT BE DETERMINED
QB - QUECHAN TRIBE OF THE FORT YUMA INDIAN RESERVATION, CALIFORNIA AND ARIZONA USE COUNTRY CODE IF MAKE CAN NOT BE DETERMINED
QCA - QUEEN CITY ARMS LLC. NEW RICHMOND,OH
QTD - QUENTIN DEFENSE; GILBERT, ARIZONA
QU - QUERETARO USE COUNTRY CODE IF MAKE CAN NOT BE DETERMINED
QSM - QUICKSILVER MANUFACTURING LLC "QSM"-TRADE NAME BUHL, IDAHO
QC - QUILEUTE TRIBE OF THE QUILEUTE RESERVATION, WASHINGTON USE COUNTRY CODE IF MAKE CANNOT BE DETERMINED
QD - QUINAULT TRIBE OF THE QUINAULT RESERVATION, WASHINGTON USE COUNTRY CODE IF MAKE CAN NOT BE DETERMINED
QR - QUINTANA ROO USE COUNTRY CODE IF MAKE CAN NOT BE DETERMINED
RRT - R & R ENTERPRISES JEFFERSON, SD
RRM - R & R EXATIC MACHINES, PEORIA, ARIZONA
RBP - R B PRECISION INC. EAST MOLINE, IL
R0D - R B R0DDA; BIRMINGHAM, ENGLAND
RRB - R BROS. RIFLES, LLC ELMA, WASHINGTON
RFG - R FAMAGE OR RAFAMANDO FACTORY/REFORMADA FACTORY OF WAR _RE-WORKED MAUSER RIFLES
RGN - R GUNS (TRADE NAME); SPORTSWEREUS INC (LICENSED NAME) _RECEIVERS ARE MARKED WITH BOTH NAMES
RNJ - R&J FIREARMS LIMITED PARTNERSHIP MCMINNVILLE, OREGON
RBF - R. B. INDUSTRIES FRASER, MI
SE - R. F. SEDGLEY, INC. SEYCHELLES USE COUNTRY CODE IF MAKE CAN NOT BE DETERMINED
RMA - R. M. A. C. ROCKY MOUNTAIN ARMS
RJB - R.J. BRAVERMAN MEREDITH,NH; MANUFACTURER OF PENPISTOL. ORIGINALLY SOLD BY AMERICAN DERRINGER
RME - R/M EQUIPMENT, INC MIAMI, FLORIDA
RMS - R0CKY M0UNTAIN ARMS, INCORPORATED
RHB - R0HRBAUGH FIREARMS;FARMINGDALE, NY
RYA - R0YSTER ARMAMENT; ENGLEW00D, C0L0RAD0
AXT - RADIAN (FORMERLY AXTS WEAPONS SYSTEMS, INC.) SALEM, OREGON
RDC - RADICAL FIREARMS, LLC STAFFORD, TEXAS
RAD - RADOM
GIV - RAFAL DEFENSE, INC. (GIVATI ARMS) ORLANDO, FLORIDA
RKF - RAICK FRERES,LIEGE,BELGIUM
RNR - RAINIER ARMS, LLC AUBURN, WASHINGTON
RLI - RAM LINE, INC.
RAM - RAMO, INCORPORATED ANTIOCH,TN
RMP - RAMPRO CORPORATION WILMINGTON,NC
RMH - RAMSHORN GUN MANUFACTURY INC., BURGHILL, OH
RAB - RAN
RTS - RANCH & SILVA (RTS) ALSO STARTER GUNS
RND - RANDALL MFG.COMPANY CALIFORNIA
RGR - RANGER ARMS, INC.MFR. OF RIFLES
RMT - RANGER MACHINE & TOOL (RMT)MFR. OF FRAMES ONLY
RA0 - RANGER PROOF ARMS, LLC TAMPA, FLORIDA
RAF - RAPID FIRE TROY, OH
RAP - RAPID-MAXIMA
RPT - RAPTOR ARMS COMPANY,LLC SHELTON, CONNECTICUT
RTR - RAPTOR ARMS MARTHASVILLE, MO
RSH - RASHEED OR RASHID; EGYPT; CARBINE USED BY EGYPTIAN MILITARY_PLACE OF ORIGIN SWEDEN RESEMBLES SOVIET SKS CARBINE
RAS - RAST & GASSER
RTL - RATLIFF TRADITIONS, LLC (HORIZON FIREARMS) COLLEGE STATION,TX
RAT - RATMIL
RAV - RAVEN ARMS CO.MFR. OF HANDGUNS
RAR - RAYMOND & ROBITAILLE
RAY - RAYON
RZ0 - RAZNO SHOTGUNS
RCW - RCW ARMS LLC DBA RIOT CONTROL WEAPONS.COM RAINIER, OR
RBM - REBEL ARMS CORP. EAST STROUDSBURG, PENNSYLVANIA
RCK - RECK
REZ - RECOIL GUNWORKS, LLC SALEM, INDIANA
REC - RECORD MATCH PISTOLS
RCB - RECREATOR BLANKS AKA MADE RIGHT PRECISION MFG LLC FALLSINGTON, PA
REE - RED CHIEFTAN BRAND OF STEVENS; VARIOUS MFRS
YH - RED CLIFF BAND OF LAKE SUPERIOR CHIPPEWA INDIANS WISCONSIN USE COUNTRY CODE IF MAKE CAN NOT BE DETERMINED
RDT - RED DAWN TACTICAL MOSES LAKE, WA
RDA - RED DIRT ARMORY, LLC MUSTANG, OK
RYS - RED EYE ARMS, LLC LAS VEGAS, NEVADA
RYM - RED EYED MUSTANGS PRECISION OUTFITTERS, INC; EL CAJON, _CALIFORNIA-ADDED/ASSIGNED 9/8/15
R0J - RED JACKET
RJF - RED JACKET FIREARMS, LLC BATON ROUGE, LOUISIANA
RL - RED LAKE BAND OF CHIPPEWA INDIANS OF MINNESOTA USE COUNTRY CODE IF MAKE CAN NOT BE DETERMINED
RRS - RED RIVER TACTICAL SUPPLY; WHITEWRIGHT, TEXAS
RRP - RED ROCK PRECISION, LLC%MORGAN UTAH
RHS - REH INDUSTRIES, LLC NORTH HIGHLANDS, CALIFORNIA
RLL - RELLIM ARM, LLC WICHITA, KS
RM0 - REMO
RPR - REMSPORT MFG. LUDLOW, MASSACHUSETTS
MNG - RENATO MENEGON BRESCIA,ITALY; MFR. RIFLE-SHOTGUN COMBINATIONS
REA - RENEGADE
URG - RENO MODEL OF URIGUEN
QE - RENO-SPARKS INDIAN COLONY, NEVADA USE COUNTRY CODE IF MAKE CAN NOT BE DETERMINED
RHW - RENSHAW FIREARMS JUPITER, FL
RBA - RENZO BONORA ARMI (D.B.A.-RBA) GRANAROLO EMILA, ITALY
RE0 - REO ENGINEERING, GALVESTON, INDIANA
RAC - REPLICA ARMS CO.MARRIETTA, OH
REP - REPUBLIC
RPA - REPUBLIC ARMS INCCHINO,CA
RSF - REPUBLIC ARMS OF SOUTH AFRICA JEPPESTOWN,SA
RPM - REPUBLIC FIREARMS STRONGSVILLE, OH
RPF - REPUBLIC FORGE, LLC (COUGAR CUSTOM GUNWERKS) PERRYTON, TEXAS
RB - REPUBLIC OF CONGO, BRAZZAVILLE CAPITAL USE COUNTRY CODE IF MAKE CAN NOT BE DETERMINED
RH - REPUBLIC OF ZIMBABWE (FORMERLY RHODESIA) USE COUNTRY CODE IF MAKE CAN NOT BE DETERMINED
RAX - RESEARCH AND TESTING WORX, INC. (RAT WORX) MT. MORRIS, ILLINOIS
RTY - RETAY ARMS LTD.STI. KONYA, TURKEY
RE - REUNION,DEPARTMENT OF USE COUNTRY CODE IF MAKE CAN NOT BE DETERMINED
RVT - REV TACTICAL,LLC EMMETT,IDAHO
REU - REVELATION
REV - REVELLI
RXT - REX TACTICAL ARMORY, LLC ABBEVILLE, LA
REX - REX VARIOUS MFRS
RX0 - REXIO S. R. L.
RFY - REYNOLDS, PLANT, & HOTCHKINS
RGI - RG (WITH NUMBERS)SEE RG INDUSTRIES REFERENCE
RHA - RHINELAND ARMS, LOUISVILLE, TEXAS
RN0 - RHINO ARMS; WASHINGTON
RI - RHODE ISLAND USE COUNTRY CODE IF MAKE CAN NOT BE DETERMINED
RH0 - RHONER/RHONIE
RIA - RICHARDS, W.IMPORTED BY H & D FOLSOM
WES - RICHARDS, WESTLEY IMPORTED BY HARRINGTON & RICHARDAON
RIC - RICHLAND ARMS CO.IMPORTER
RRC - RIEDLT RIFLE CO.MFR OF SINGLE-SHOT RIFLES
RFK - RIFENBARK ARMORY, LLC PINCONNING, MI
RFE - RIFLE GEAR.COM FOUNTAIN VALLEY, CA
CRR - RIFLEMAN CONSULTING, LLC (CITIZEN ARMS) CARTHAGE, NC
RID - RIGAUD
RYL - RILEY DEFENSE, INC. CHARLOTTE, NORTH CAROLINA
RI0 - RIO; PERCUSSION PISTOLS
RSM - RISE ARMAMENT BROKEN ARROW, OK
RIL - RIVAL
RVL - RIVAL
RVN - RIVERMAN LLC COEUR D ALENE, ID
RWX - RMW EXTREME PALMETTO, FLORIDA
RNM - RND MANUFACTURING; LONGMONT, COLORADO
RBC - ROBAR CO INC PHOENIX,AZ
RDK - ROBAR ET DEKERKHOVE EARLY MFG OF RIFLES
RBL - ROBBINS & LAWRENCE
RFM - ROBERTS FIREARMS MANUFACTURING, OSSIAN, IN
R0B - ROBINSON ARMAMENT COMPANY SALT LAKE CITY, UT
R0I - ROCK ISLAND ARMORY COMMERCIAL MFG--DO NOT CONFUSE WITH ROCK ISLAND (MILITARY ARSENAL)
R0P - ROCK PISTOL MFG.
RRA - ROCK RIVER ARMS CLEVELAND,IL
RMG - ROCKY MOUNTAIN GUNS, INC. AURORA, COLORADO
RPG - ROCKY POINT GUNS & AMMO ROCKY POINT, NC
R0K - ROGAK, INC.9MM SEMIAUTOMATIC PISTOL,SKOKIE, IL
R0G - ROGER
R0E - ROGERS & SPENCER-CIVIL WAR REPLICAS
RG0 - ROGGIO ARSENAL ; FAYETTEVILLE, NC
RUG - ROGUE DEFENSE, LLC MILWAUKIE, OREGON
RRI - ROGUE RIFLE CO. PROSPECT,OR
R0N - ROLLIN WHITE ARMS
RU - ROMANIA/RUMANIA USE COUNTRY CODE IF MAKE CAN NOT BE DETERMINED
RMC - ROMARM/CUGIR ROMAK-ROMARM / DRACO-AK 47 TYP FIREARMS
RRN - ROME REVOLVER & NOVELTY CO.
R0H - ROMER/ROMERWERK
RTA - ROMTEHNICA
QF - ROSEBUD SIOUX TRIBE OF THE ROSEBUD INDIAN RESERVATION, SOUTH DAKOTA USE COUNTRY CODE IF MAKE CAN NOT BE DETERMINED
R0W - ROSEBUSH, WALDO
R0R - ROSS RIFLE
R0F - ROTH FROMMER
R0S - ROTH-SAUER
RST - ROTH-STEYR
RBY - ROUBY MFR OF ELECTRIC SHOTGUNS
RFL - ROUGHNECK FIREARMS, LLC HIGHLANDS, TEXAS
PGS - ROUGHRIDER ARMS, LLC (PREPPER GUN SHOP) GRAND FORKS, NORTH DAKOTA
R0U - ROUTLEDGE MFG. CO.
RWT - ROWE TACTICAL POTTSTOWN, PA
WEA - ROY WEATHERBY MFG OF RIFLES AND SHOTGUNS
R0Y - ROYAL GUN CO.
R0V - ROYAL SERVICE VARIOUS MFRS
R0Z - ROYAL SMALL ARMS
RPI - RPA INTERNATIONAL, LTD; UNITED KINGDOM
RPB - RPB INDUSTRIES
RPP - RPG GUNSMITH (PARTRIDGE, R.F) BERLIN, MD
RSS - RSI TAC, LLC (RIFLE SUPPLY) HUNTINGTON BEACH, CA
RSD - RSS DEFENSE CORP. WAUCONDA, IL
RTM - RT MANUFACTURING CO., INC., WAUCONDA, ILLINOIS
RTD - RTD, MFG. GOFFSTOWN, NEW HAMPSHIRE
RTT - RTT MOTORSPORTS & STABILIZERS, LLC; LAKE HAVASU CITY, ARIZONA
RUA - RUAG AMMOTEC GMBH FUERTH, GERMANY
RBI - RUBI
RUB - RUBY ARMS CO.
RNI - RUN N IRON, LLC BERTRAND, NEBRASKA
RRG - RUNNER RUNNER GUNS MCKINNEY, TX
RUR - RURAL
RA - RUSSIA USE COUNTRY CODE IF MAKE CAN NOT BE DETERMINED
RF - RUSSIAN FEDERATION USE COUNTRY CODE IF MAKE CAN NOT BE DETERMINED
RUU - RUSSO-CHINOIS
RW - RWANDA USE COUNTRY CODE IF MAKE CAN NOT BE DETERMINED
KKV - RWC GROUP, LLC%KALASHNIKOV USA POMPANO BEACH FLORIDA
RWS - RWS/DIANA MFGR OF AIRGUNS
RYE - RYAN, E. PISTOL MFG. CO.
SH0 - S & H ARMS OF OKLAHOMA; OWASSO, OKLAHOMA
SSY - S&S ARMORY PORTLAND, TN
SZZ - S&T MOTIV COMPANY, LTD BUSAN, SOUTH KOREA
SSB - S-BEAM PRECISION PRODUCTS, LTD. ZHONGSHAN CITY, CHINA
SAY - S. A. (SUINAGA Y ARAMBERRI)MFR. OF REVOLVERS, SEE ALSO VICTORARAMBERRI & SONS
SAB - S. A. AUTOMATIQUE
SAC - S. A. C. M.
SAG - S. A. G. M. OR S. A. G. E. M.
SEQ - S. E. A. M.
SIA - S. I. A.
NVV - S.C. NOVA GRUP, S.R.L. CUGIR, ROMANIA
ICE - S.I.A.C.E.; BRESCIA, ITALY
SBB - SABAL ARMS, INC. MIAMI, FLORIDA
SAF - SABATIER
SAA - SABATTI & TANFOGLIO
SBT - SABER TACTICAL, INC. INDIAN TRAIL, NORTH CAROLINA
SDI - SABRE DEFENCE INDUSTRIES, LLC NASHVILLE, TN
QG - SAC AND FOX NATION OF MISSOURI IN KANSAS AND NEBRASKA USE COUNTRY CODE IF MAKE CAN NOT BE DETERMINED
FX - SAC AND FOX NATION OF OKLAHOMA USE COUNTRY CODE IF MAKE CAN NOT BE DETERMINED
QH - SAC AND FOX TRIBE OF THE MISSISSIPPI IN IOWA USE COUNTRY CODE IF MAKE CAN NOT BE DETERMINED
SD - SACO DEFENSE SACO,ME DESERT EAGLE PISTOLS MAGNUM RESEARCHAND SOMEWEATHERBY RIFLES; SOUTH DAKOTA USE COUNTRY CODE IF MAKE CANN
SZY - SACRAMENTO BLACK RIFLE ROCKLIN, CALIFORNIA
SMG - SAEIL0 MANUFACTURING INDUSTRIES; W0RCHESTER, MA
SFT - SAFESIDE TACTICAL, LLC VINTON, VIRGINIA
SFH - SAFETY HARBOR FIREARMS; SAFETY HARBOR, FL
SFV - SAFFLE INDUSTRIES,LLC (SIERRA NEVADA ARMS) RENO, NEVADA
SFR - SAFIR ARMS CO (TURKEY)
QI - SAGINAW CHIPPEWA INDIAN TRIBE OF MICHIGAN USE COUNTRY CODE IF MAKE CAN NOT BE DETERMINED
SAS - SAHSHO LTD.
QJ - SAINT REGIS MOHAWK TRIBE, NEW YORK (FORMERLY THE ST REGIS BAND OF MOHAWK INDIANS OF NEW YORK) USE COUNTRY CODE IF MAKE CAN NO
SLF - SALFORD IMPORTS
SLE - SALIENT ARMS INTERNATIONAL; OXNARD, CALIFORNIA
QK - SALT RIVER PIMA-MARICOPA INDIAN COMMUNITY OF THE SALT RIVER SERVATION, ARIZONA USE COUNTRY CODE IF MAKE CAN NOT BE DETERMINED
STS - SALT WORKS RIFLES HESPERIA, CA
SMQ - SAMCORP, INC. LAKE HAVASU CITY, AZ
QL - SAMISH INDIAN TRIBE, WASHINGTON USE COUNTRY CODE IF MAKE CAN NOT BE DETERMINED
SSC - SAMSON MANUFACTURING CORP. WHATELY,MA
QM - SAN CARLOS APACHE TRIBE OF THE SAN CARLOS RESERVATION, ARIZONA USE COUNTRY CODE IF MAKE CAN NOT BE DETERMINED
SJE - SAN JUAN ENTERPRISES; WHEATRIDGE, COLORADO
YJ - SAN JUAN SOUTHERN PAIUTE TRIBE OF ARIZONA USE COUNTRY CODE IF MAKE CAN NOT BE DETERMINED
SL - SAN LUIS POTOSI USE COUNTRY CODE IF MAKE CAN NOT BE DETERMINED
SH - SAN MARINO USE COUNTRY CODE IF MAKE CAN NOT BE DETERMINED
SNM - SAN MARTIN; EIBAR SPAIN
SPL - SAN PAULO BRAND OF SHOTGUN(MFR.UNKNOWN)
SNQ - SAN TAN TACTICAL AKA STT CHANDLER, AZ
SAD - SANDERS
SAE - SANDERSON
SAN - SANGENHAU
SNB - SANTA BARBARA RIFLES IMPORTED BY CONNECTICUT VALLEY ARMS
QN - SANTEE SIOUX NATION, NEBRASKA USE COUNTRY CODE IF MAKE CAN NOT BE DETERMINED
TP - SAO TOME & PRINCIPE USE COUNTRY CODE IF MAKE CAN NOT BE DETERMINED
SRQ - SARAQUESTA, VICTORMFR. OF SHOTGUNS
SRD - SARDIUS INDUSTRIES
SAM - SARMCO
SMZ - SARSILMAZ (SAR ARMS) TURKEY
SSD - SAS INC. CHINA
SN - SASKATCHEWAN USE COUNTRY CODE IF MAKE CAN NOT BE DETERMINED
SB - SAUDI ARABIA USE COUNTRY CODE IF MAKE CAN NOT BE DETERMINED
Q0 - SAUK-SUIATTLE INDIAN TRIBE OF WASHINGTON USE COUNTRY CODE IF MAKE CAN NOT BE DETERMINED
QP - SAULT SAINTE MARIE TRIBE OF CHIPPEWA INDIANS OF MICHIGAN USE COUNTRY CODE IF MAKE CAN NOT BE DETERMINED
SVV - SAVANNAH RIVER ARMORY, INC. MARTINEZ, GEORGIA
S0H - SAWTOOTH TACTICAL, LLC BOISE, ID
SBF - SB FIREARMS, LLC (SCHROEDER BAUMAN) FT WAYNE,INDIANA PARENT COMPANY SWS-TRIMAC ASSOCIATED WITH SB FIREARMS
SBD - SBL INDUSTRIES ISRAEL
SNT - SCHEINTOD/SCHEINTOT MFG OF HANDGUNS
SGW - SCHEUTZEN GUN WORKS ALSO SGW ENTERPRISES & OLYMPIC ARMS
SHI - SCHILLING
SHM - SCHIMEL GAS/AIR PISTOL
SCI - SCHINTAD
SSG - SCHMEISSER & SIMPSON
SSR - SCHMEISSER GMBH GERMANY
SCM - SCHMEISSER MFG BY C. G. HAENEL, ERMA AND OTHERS
SCQ - SCHMIDT-RUBIN SWISS MILITARY RIFLE
SCN - SCHONBERGER
SCF - SCHOULHOF, WIEN
SHV - SCHOVER SINGLE SHOT RIFLES
SCL - SCHULTZ/LARSEN
SHG - SCHUYLER, HARTLEY, & GRAHAM
SR0 - SCORPIO TACTICAL, INC; EUSTIS, FL NOT SAME AS SCORPION TACTICAL INC-TEXAS MAK/SRT)
SCP - SCORPION
S0E - SCORPION ARMAMENTS, INC. LAKE PARK, FL
SRT - SCORPION TACTICAL INC; LEANDER, TEXAS NOT SAME AS "SCORPIO TACTICAL,INC. EUSTIS, FLORIDA MAK/SR0
SS - SCOTLAND OR UN FOR UNITED KINGDOM USE COUNTRY CODE IF MAKE CAN NOT BE DETERMINED
SCX - SCOTSMAN ARMS, LLC; EAU CLAIRE, WISCONSIN ADDED/ASSIGNED 8/4/15
SCT - SCOTT ARMS CO.
WS - SCOTT MFD BY WEBLEY & SCOTT WESTERN SAMOA USE COUNTRY CODE IF MAKE CAN NOT BE DETERMINED
STC - SCOTT'S TACTICAL SUPPLY AKA STS ROCKINGHAM, NC
STT - SCOTTI
SCU - SCOUT
SCD - SCSG (BRIAN T. WALKER) WOODBINE, MARYLAND
SDC - SD TACTICAL ARMS LLC PRESCOTT, AZ
SER - SEARS ROEBUCK & CO.USE ONLY WHEN MFR IS UNKNOWN
XA - SEBRIA USE COUNTRY CODE IF MAKE CANNOT BE DETERMINED
SMY - SECOND AMENDMENT ARMORY KNOXVILLE, TN
SDL - SECOND TACTICAL CLARKSVILLE, TN
SSU - SECRET SERVICE MFD BY HOWARD ARMS, U.S. REVOLVER COMPANY AND SEVERAL OTHERS
SCA - SECURITY ALLSTAR HENDERSONVILLE, TN
SCY - SECURITY INDUSTRY OF AMERICA, INC.HANDGUNS
SED - SEDCO INDUSTRIES; LAKE ELSINORE, CA
SEP - SEECAMP, L. W.MILFORD, CT
SKP - SEEKINS PRECISION; LEWISTON, IDAHO
SGP - SEGAP GROUP, LLC (AMF DEFENSE) NEW BALTIMORE, MICHIGAN
SLG - SELECT FIRE GROUP (AMMO DOGS) FRESNO, CA
SWP - SELECT WEAPON SYSTEMS, INC. WALNUT CREEK,CA
SK - SEMINOLE NATION OF OKLAHOMA USE COUNTRY CODE IF MAKE CAN NOT BE DETERMINED
QQ - SEMINOLE TRIBE OF FLORIDA (DANIA, BIG SYPRESS, BRIGHTON, HOLLYWOOD, AND TAMPA RESERVATIONS)
SEM - SEMMERLING CORP.MFR. OF HANDGUNS
SND - SENDRA CORPORATION
QS - SENECA NATION OF NEW YORK USE COUNTRY CODE IF MAKE CAN NOT BE DETERMINED
DV - SENECA-CAYUGA TRIBES OF OKLAHOMA USE COUNTRY CODE IF MAKE CAN NOT BE DETERMINED
SG - SENEGAL USE COUNTRY CODE IF MAKE CAN NOT BE DETERMINED
SLL - SENSIBLY ARMED (COLLINGWOOD ENTERPRISES, LLC) READING, PENNSYLVANIA
SET - SENTINAL ARMS RIDGWAY, PA-STRYKER MODEL OF ARMS
SBU - SERBU FIREAMS, INC. TAMPA, FL
SGT - SERENGETI; WALKABOUT, AFRICAN, MONTANAN, RED MIST MODELS
SRS - SERITSAN_ ISMIR, TURKEY
SRF - SERRIFILE, INC.LANCASTER, CA
SRV - SERVICE ARMAMENT CO.IMPORTER
SUT - SG ARMS,INC (SOUTHERN GUNS) LONGWOOD,FL
SVI - SH0ELESS VENTURES, INC.; CARS0N CITY, NEVADA; MAKER OF FAB 10 RECEIVERS, AS OF 2/2005 FAB-10 IS NOW TRADE NAME,NO LONGER MAR
S0W - SHADOW OPS WEAPONRY, LLC LONGMONT, COLORADO
SS0 - SHADOW SOLUTIONS, LLC LUTZ, FL
SYT - SHADOW SYSTEMS, LLC PLANO, TEXAS
SHD - SHADOW/SHADOW INDY-MODEL OF SHOTGUNS
SKW - SHADOWOOD ENTERPRISES, LLC (KENTUCKY WINDAGE)%HURST TX
YK - SHAKOPEE MDEWAKANTON SIOUX COMMUNITY OF MINNESOTA USE COUNTRY CODE IF MAKE CAN NOT BE DETERMINED
KP - SHAKOPEE USE COUNTRY CODE IF MAKE CAN NOT BE DETERMINED
SFM - SHAN DONG FIRST MACHINERY COMPANY, CHINA
SHP - SHAPLEIGH HARDWARE CO.DISTRIBUTOR OF SHOTGUNS
SKC - SHARK COAST TACTICAL, LLC SARASOTA, FLORIDA
SHK - SHARPS & HANKINS-CIVIL WAR CARBINES
SHS - SHARPS RIFLE CO.LLC (TRADE NAME SHARPS MIL SPEC) ST LOUIS,MO (AR15'S)
YL - SHAWNEE TRIBE, OKLAHOMA USE COUNTRY CODE IF MAKE CAN NOT BE DETERMINED
SHF - SHEFFIELD
SSH - SHEFFIELD TACTICAL SHEFFIELD, PENNSYLVANIA
SHH - SHEPHERD FIREARMS, LLC WARSAW, INDIANA
SFF - SHERIFF'S MODEL
PQI - SHERPAO ARMS FACTORY PESHAWAR, PAKISTAN
SHL - SHERRILL ARMS HUNTSVILLE, AL
S0Q - SHERWOOD ARMORY, LLC OKEMOS MICHIGAN ADDED/ASSIGNED 2/2/16
SLD - SHIELD ARMS, LLC. BIG FORK, MONTANA
SKI - SHIKI (COPY MAUSER M. P.)SHANGHAI ARSENAL
SRI - SHILEN RIFLES, INC.MFR. OF CUSTOM RIFLES
SLH - SHILOH PRODUCTS (SHARPS RIFLE)MFR. OF CUSTOM RIFLES
SCK - SHIN CHUO KOHYO, K. K.MFR. OF SHOTGUNS AND PISTOLS
SBA - SHINBISHA; JAPAN MAKER OF SHOTGUNS
SKN - SHINKOSHA
SNN - SHINN-A-SIPJASEOUL, SOUTH KOREA
QT - SHOALWATER BAY TRIBE OF THE SHOALWATER BAY INDIAN RESERVATION, WASHINGTON USE COUNTRY CODE IF MAKE CAN NOT BE DETERMINED
SMN - SHOOTERS ARMS MANUFACTURING (S.A.M.) PHILIPPINES
SDT - SHOOTERS DEPOT, CORPUS CHRISTI, TEXAS
SSA - SHORT ACTIONS CUSTOMS, LLC; WELLINGTON, OHIO _ADDED/ASSIGNED 5/1/14
SFY - SHORT DEFENSE SYSTEMS INC. HOOVER, AL
YM - SHOSHOE TRIBE OF THE WIND RIVER RESERVATION, WYOMING USE COUNTRY CODE IF MAKE CAN NOT BE DETERMINED
QV - SHOSHONE-BANNOCK TRIBES OF THE FORT HALL RESERVATION OF IDAHO USE COUNTRY CODE IF MAKE CAN NOT BE DETERMINED
QW - SHOSHONE-PAIUTE TRIBES OF THE DUCK VALLEY RESERVATION, NEVADA USE COUNTRY CODE IF MAKE CAN NOT BE DETERMINED
SHU - SHUE'S SPECIAL
SIC - SICKLES ARMS CO. (SICKLES &
SIW - SIERRA 1 GUN WORKS, LLC YUKON, OK
SIE - SIERRA ARMS CO.
SA - SIERRE LEONE (SIERRA LEONE) USE COUNTRY CODE IF MAKE CAN NOT BE DETERMINED
SIG - SIG ARMS NAME CHANGED TO: SIG SAUER TO ALLIGN WITH GLOBAL BRAND
SEK - SIGNATURE MARKETING, INC. (SMI) MERRIAM, KANSAS
SKS - SILAH MAKINA KLIP SAN, TIC, LTD. IZMIR TURKEY;TRADENAME HATSANARMS
SIL - SILE DISTRIBUTORS, INC.
SCC - SILENCERCO, LLC; WEST VALLEY CITY, UTAH
SSP - SILMA SPORTING GUN-BRESCIA, ITALY
SVC - SILVER CREEK FIREARMS INC, WHITEHALL,MI
SVS - SILVER SEITZ, PARKTON, MD ; TRAP GUNS
SIM - SIMMONS
SIV - SIMONOV-SOVIET AK RIFLES
SMP - SIMPLEX IMPORTED BY STOEGER
SEL - SIMSON
SI - SINALOA USE COUNTRY CODE IF MAKE CAN NOT BE DETERMINED
SIN - SINGER MFG BY FRANCISCO ARIZMENDI AND FRANTISEK DUESK
SI0 - SIONICS WEAPONS SYSTEMS TUCSON, AZ
SIR - SIRKIS INDUSTRIES, LTD.
QX - SISSTON-WAHPETON OYATE OF THE LAKE TRAVERSE RESERVATION, SOUTH DAKOTA USE COUNTRY CODE IF MAKE CAN NOT BE DETERMINED
SSE - SITES-BRESCIA, ITALY
SIT - SITES SPECTERRAMAT-GAN, ISRAEL
SIS - SIVISPACEM
SIX - SIX DOGS (SIX DOGS ARMORY, CHRISTOPHER LYNN) ROSWELL, NM
SXX - SIX SIGMA ARMS, LLC BRAHAM, MINNESOTA
SK0 - SKODA
QY - SKOKOMISH INDIAN TRIBE OF THE SKOKOMISH RESERVATION, WASHINGTON USE COUNTRY CODE IF MAKE CAN NOT BE DETERMINED
QZ - SKULL VALLEY BAND OF GOSHUTE INDIANS OF UTAH USE COUNTRY CODE IF MAKE CAN NOT BE DETERMINED
SKG - SKY GUNS INTERNATIONAL, LLC (SGI) DALLAS, GEORGIA
SDJ - SKY JACKER DEFENSE, LLC DBA SDJ NORCROSS, GA
SKY - SKYY INDUSTRIES, LLC, SOUTH DAYTONA, FL *2008 COMPANY HAS CHANGED ITS NAME TO : SCCY INDUSTRIES (CODE WILL STAY AS IS)
SLV - SLAVIA
SLR - SLLR
LF - SLOVAKIA USE COUNTRY CODE IF MAKE CAN NOT BE DETERMINED
L0 - SLOVENIA USE COUNTRY CODE IF MAKE CAN NOT BE DETERMINED
RRF - SLR RIFLEWORKS, LLC WINTER GARDEN, FLORIDA NOT TO BE CONFUSED WITH SLR15 RIFLES INC. (DEFENSIVE EDGE) OUT OF MN
SRL - SLR15 RIFLES, INC (ANDOVER, MN ALSO ANOKA, MN)
SLB - SMALL ARMS LIMITED LONG BRANCH ; CANADIAN FIREARM, CANADA MARKS THE FIREARM LONG BRANCH
SMA - SMIMURA-DISTRIBUTOR
SW - SMITH & WESSON OR SWAZILAND USE COUNTRY CODE IF MAKE CANNOT BE DETERMINED
SMI - SMITH (NOT SMITH & WESSON)
SNP - SMITH ENTERPRISES TEMPE,AZ SEMI-AUTO M14 STYLE RIFLES
SMT - SMITH MANUFACTURING COMPANYHOLLAND, OH
SFG - SMITH MANUFACTURING GROUP; DECATUR, TEXAS
SMS - SMITH-SONIANMFD. BY CRESCENT OR HARRINGTON &RICHARDSON
SRW - SMK RIFLE WORKS, LLC LAREDO, TX
SMK - SMOK
TXS - SMR MANUFACTURING, LLC (SOUTH TEXAS ARMS) KYLE, TX
SN0 - SNOWY MOUNTAIN RIFLE COMPANY, LLC; MISSOULA, MONTANA ADDED/ASSIGNED 10/20/15
SNS - SNS INDUSTRY INC.SNOHOMISH, WASHINGTON
RV - SOCIALIST REPUBLIC OF VIETNAM (FORMERLY VIETNAM) USE COUNTRY CODE IF MAKE CAN NOT BE DETERMINED
S0C - SOCIETE ANONYME
S0D - SOCIETE D'ARMES
SFC - SOFINOCON ENTERPRISES, LLC LOS CATOS,CA
S0M - SOG ARMORY, INC; HOUSTON, TEXAS PER ATF TRACING GRP
YN - SOKAOGON CHIPPEWA COMMUNITY, WISCONSIN USE COUNTRY CODE IF MAKE CAN NOT BE DETERMINED
S0K - SOKOLOVSKY CORP. SUNNYVALE, CA
SVU - SOL INVICTUS ARMS,LLC MELBOURNE,FLORIDA
SCS - SOLID CONCEPTS INC.AUSTIN, TX (MAILING ADDRESS OF VALENCIA,CA
SLC - SOLINGEN CUTLERY; IMPORTER SEE LIBERTY ARMS
BS - SOLOMON ISLANDS (FORMERLY BRITISH SOLOMON ISLANDS) USE COUNTRYCODE IF MAKE CAN NOT BE DETERMINED
S0N - SOLOTHURN
S0L - SOLWAY
SM - SOMALIA USE COUNTRY CODE IF MAKE CAN NOT BE DETERMINED
SID - SONJU INDUSTRIAL (D.B.A.-SI DEFENSE) KALISPELL, MONTANA
S0 - SONORA USE COUNTRY CODE IF MAKE CAN NOT BE DETERMINED
S0R - SONORAN ARMS LLC MESA, AZ
SSW - SONS OF LIBERTY GUN WORKS, LLC SAN ANTONIO, TEXAS
SNK - SONTEK; TURKEY
S0P - SOPER
SKR - SOROKA RIFLE CO; NEW ZEALAND
0TR - SOTA ARMS INC. NORTH BRANCH, MN
SDH - SOUND TECH APR; PELHAM ALABAMA
SF - SOUTH AFRICA USE COUNTRY CODE IF MAKE CAN NOT BE DETERMINED
SC - SOUTH CAROLINA USE COUNTRY CODE IF MAKE CAN NOT BE DETERMINED
GS - SOUTH GEORGIA & THE SOUTH SANDWICH ISLANDS USE COUNTRY CODE IF MAKE CAN NOT BE DETERMINED
K0 - SOUTH KOREA USE COUNTRY CODE IF MAKE CAN NOT BE DETERMINED
ZF - SOUTH SUDAN USE COUNTRY CODE IF MAKE IS NOT AVAILABLE
SXW - SOUTH TEXAS TACTICAL WEAPONS, BROWNSVILLE TX
SWR - SOUTHEASTERN WEAPONRY RESEARCH; EVANS, GEORGIA
S0A - SOUTHERN ARMAMENT, LLC LOUISVILLE, KENTUCKY
SUM - SOUTHERN ARMS MFG. LLC BEAUMONT, TX
SG0 - SOUTHERN GUNS, LLC (ALPHA OMEGA WEAPONRY) LONGWOOD, FLORIDA
RJ - SOUTHERN UTE INDIAN TRIBE OF THE SOUTHERN UTE RESERVATION, COLORADO USE COUNTRY CODE IF MAKE CAN NOT BE DETERMINED
S0T - SOUTHWEST MANUFACTURING CHANDLER,AZ
SWN - SOUTHWESTERN FIREARMS INC. DBA SWFA INC. RED OAK, TX
SP - SPAIN USE COUNTRY CODE IF MAKE CAN NOT BE DETERMINED
SPD - SPANDAU ROYAL ARSENAL
SPH - SPANISH AMERICAN WAR VINTAGESPRINGFIELD ARMORY, SPRINGFIELD, IL
PTS - SPARTA ARMS, LLC SPARTA, TN
SPU - SPARTAC MANUFACTURING,LLC LARGO,FLORIDA
SSF - SPARTAN PRECISION RIFLES SAN JOSE, CA
SCZ - SPEC ARMS,LLC SPARTA, MICHIGAN
SLI - SPECIAL INTEREST ARMS (LICENSE-SIA) GARDNERVILLE, NV
SLT - SPECIAL OPS TACTICAL LLC APOPKA, FL
SPE - SPECIAL SERVICE
S0U - SPECIAL TOOL SOLUTIONS INC.JACKSONVILLE, FL
SWS - SPECIAL WEAPONS AND INDIVIDUAL
SWL - SPECIAL WEAPONS LLC TEMPE, AZ; H&K TYPE WEAPONS
SZD - SPECIALIZED DYNAMICS LLC CHANDLER, AZ
SLS - SPECIALIZED TACTICAL WEAPONS AKA STS OGDEN, UTAH
SLA - SPECIALTY ARMS MFD SPRINGFIELD, OH
SPZ - SPECOP MANUFACTURING LISLE, NEW YORK
SPQ - SPENCER RIFLE C0MPANY; P0RTLAND, TN NOT TO BE CONFUSED WITH SPENCER GUN CO ETC
SPG - SPENCER RIFLE CIVIL WAR MILITARY
SPS - SPESCO CORP.IMPORTER AND MFR.
SES - SPESCOVARIOUS MFRS.
SPX - SPHINX ENGINEERING, SAFORMER ITM
SDR - SPIDER FIREARMS; ST. CL0UD, FL0RIDA
SPK - SPIKES TACTICAL LLC APOPKA, FLORIDA
SPB - SPILLER & BURR CIVIL WAR REVOLVERS
RK - SPIRIT LAKE TRIBE, NORTH DAKOTA (FORMERLY DEVIL'S LAKE SIOUX TRIBE NORTH DAKOTA (DL)) USE COUNTRY CODE IF MAKE CAN NOT BE DET
SPI - SPIRLET
SRE - SPITFIRE MFG. CO.POLICE CARBINES
UWK - SPITFIRE-SUPER 777 STARTER GUN MFG BY UNIWERKE
RM - SPOKANE TRIBE OF THE SPOKANE RESERVATION, WASHINGTON USE COUNTRY CODE IF MAKE CAN NOT BE DETERMINED
SPF - SPORT ARM OF FLORIDA
SPP - SPORTARMS
SP0 - SPORTCO
SRA - SPORTING ARMS CO.MFR. OF SHOTGUNS
SGI - SPORTING ARMS INC., DALLAS TEXAS; NOT SAME AS SPORTING ARMS MFG (SAP) OR SPORTING ARMS CO., MFG (SRA)
SAP - SPORTING ARMS MFG.LITTLEFIELD, TX
SPM - SPORTSMAN NAMES OD HARRINGTON & RICHARDSON, CREASENT AND VARIOUS OTHER MFGRS
TE - SPRATLY ISLANDS USE COUNTRY CODE IF MAKE CAN NOT BE DETERMINED
SPW - SPREEWERK GUNS% "CYQ" OR "CVQ" STAMPED ON THE GUN
SPR - SPRINGFIELD ARMS CO.NAME USED BY CRESCENT, SAVAGE, ANDWARNER ARMS CORP.
SII - SPRINGFIELD FIREARMS-SPRINGFIELD, MA
RN - SQUAXIN ISLAND TRIBE OF SQUAXIN ISLAND RESERVATION, WASHINGTON USE COUNTRY CODE IF MAKE CAN NOT BE DETERMINED
CY - SRI LANKA (FORMERLY CEYLON) USE COUNTRY CODE IF MAKE CAN NOT BE DETERMINED
SNR - SRM INC. MERIDIAN, IDAHO
SGL - SSG TACTICAL, LLC FREDERICKSBURG, VA
SSI - SSK INDUSTRIES, WINTERSVILLE, OHIO
YI - ST CROIX CHIPPEWA INDIANS OF WISCONSIN USE COUNTRY CODE IF MAKE CAN NOT BE DETERMINED
PS - ST PIERRE & MIQUELON, TERRITORIAL COLLECTIVITY OF USE COUNTRY CODE IF MAKE CAN NOT BE DETERMINED
VV - ST VINCENT & THE GRENADINES USE COUNTRY CODE IF MAKE CAN NOT BE DETERMINED
SA0 - ST. GOTTHARDT
SAH - ST. HUBERT
SAI - ST. LOUIS ARMS CO.IMPORTED BY FOLSOM FOR HUNTER ARMS
SGM - STAG ARMS; NEW BRIT0N, CT
STB - STAGGS BILT PRODUCTSSERIAL NUMBERS 1 THRU 2000
SDA - STALLARD ARMS
SGS - STAN'S GUNSMITHING SERVICE WEBSTER,NH
STD - STANDARD ARMS CO.
SNV - STANDARD ARMS OF NEVADA RENO, NV; NOT SAME AS STANDARD ARMS COMPANY (STD) IN DELAWARE
SMU - STANDARD MANUFACTURING COMPANY, LLC NEW BRITAIN, CONNECTICUT
SPC - STANDARD PRODUCTS CO.MFR. OF MILITARY-STYLE CARBINES
R0 - STANDING ROCK SIOUX TRIBE OF NORTH AND SOUTH DAKOTA USE COUNTRY CODE IF MAKE CAN NOT BE DETERMINED
SNL - STANLEY-IMPORTED BY H & D FOLSOM
STY - STANLEY ARMS CO.
S00 - STANLEY TOOL CO. THE STANLEY
SFI - STARLOS FIREARMS, LLC; OLYMPIA, WASHINGTON
ZUM - STAR RIFLES, LLC (ZUMBAUGH RIFLES/STRADER FIREARMS) SHERIDAN, IN
STM - STARR ARMS CO.MFR. OF CIVIL WAR CARBINES
SGU - STATE ARMS GUN CO.WAUNAKEE, WI; MFR. OF RIFLES -KLAUS HORSTKAMP.
SDS - STATE OF READINESS ARMS, LLC%HUMBLE TEXAS
SLZ - STEALTH ARMS, LLC CELINA, OHIO
SLM - STEEL CITY ARMS-PITTSBURGH, PA
SMF - STEELVILLE MFR. CO.
FUG - STEELWILL INVESTMENTS, INC.- INTERNATIONAL FIREARMS (PTAC) SAN LUIS OBISPO, CALIFORNIA
SGG - STEGG LIMITED, (CANADA & U.S) FIREARM COMPONENTS
STN - STEN SUBMACHINE GUNS
WST - STENDA/STENDA WERKEWAFFENFABRIK-STENDA WERKE
SGA - STERLING ARMS MFGR OF HANDGUNS
SWU - STERLING ARSENAL WORKS & TACTICAL SUPPLY, LLC _STERLING, VIRGINIA-ASSIGNED/ADDED 5/1/14
STL - STERLING SUBMACHINE GUNS
SWH - STERLINGWORTH II
SRN - STERN STARTED GUNS
STW - STEWART
SYA - STEYR ARMS, INC. BESSEMER, ALABAMA
STI - STI INTERNATIONAL GEORGETOWN, TEXAS
YQ - STILLAGUAMISH TRIBE OF WASHINGTON USE COUNTRY CODE IF MAKE CAN NOT BE DETERMINED
STF - STILLERS PRECISI0N FIREARMS; WYLIE, TX
STG - STINGER MANUFACTURING CORPORATION; SAULT ST MARIE, MI
SNG - STINGER SYSTEMS; TAMPA, FLORIDA
YP - STOCKBRIDGE MUNSEE COMMUNITY.WISCONSIN USE COUNTRY CODE IF MAKE CAN NOT BE DETERMINED
STZ - STOEGER ARMS IMPORTER; FRANCE, GERMAY AND SPAIN
SFL - STONEFIRE ARMS, LLC COVINGTON, WASHINGTON
SAJ - STONER ARMS, LLC KEIZER, OREGON
SLK - STORM LAKE MACHINE INC. LENOIR CITY,TN
SRM - STORMSINGLE-SHOT RIFLES
STH - STRAYER TRIPP, INTERNATIONAL (SOLD TO STI-KEPT NAME & CODE)
SVT - STRAYER-VOIGT GRAND PRARIRE, TX MFR OF PISTOLS AUSTIN, TX MANUFACTURERS COLT 1911 MODEL MODEL 2011
SSZ - STS ARMS, LLC TOLEDO, OREGON
SBM - STUBBORN MULE OUTDOOR SUPPLY LLC; GRANTS PASS, OREGON
SUG - STUMPIE'S CUSTOM GUNS, INC. SWANSBORO, NC
SR - STURM, RUGER AND COMPANY, INC. AKA RUGER SOUTHPORT, CT
SDG - SUCESOR DE E GUISASOLA
SU - SUDAN USE COUNTRY CODE IF MAKE CAN NOT BE DETERMINED
SUD - SUDAREV
SZS - SULZER FIREARMS, LLC BATON ROUGE, LA
RP - SUMMIT LAKE PAIUTE TRIBE OF NEVADA USE COUNTRY CODE IF MAKE CAN NOT BE DETERMINED
SNC - SUN CITY MACHINERY CO., LTD-PEOPLES REPUBLIC OF CHINA
SDM - SUN DEVIL MANUFACTURING; MESA, ARIZONA
SNI - SUNDANCE INDUSTRIES N. HOLLYWOOD, CA
SU0 - SUOMI MFGR OF SUB MACHINE GUNS
SUP - SUPER DESTROYER
SXC - SUPER SIX CLASSIC, LLC FORT ATKINSON, WI
SUI - SUPERIOR-VARIOUS MFGRS
SUR - SUPERIOR ARMS INC. WAPELLO, IA
SUA - SUPPRESSED ARMAMENT SYSTEMS; EVANSVILLE, INDIANA
SLW - SUPRESSED TACTICAL WEAPONS INC OR (STW) ROUGEMONT, NC
RQ - SUQUAMISH INDIAN TRIBE OF THE PORT MADISON RESERVATION, WASHINGTON USE COUNTRY CODE IF MAKE CAN NOT BE DETERMINED
SSL - SURE SURVIVAL, LLC TAMPA, FLORIDA
SFN - SUREFIRE INSTITUTE LAKE HAVASU CITY, AZ
SRR - SUREFIRE, LLC; SANTA ANA, CALIFORNIA
SCG - SURF CITY GUNS & AMMO INC. SURF CITY, NC
SRG - SURGEON RIFLES, INC; PARGUE, OKLAHOMA
ZC - SURINAM USE COUNTRY CODE IF MAKE CANNOT BE DETERMINED
SRP - SURPLUS AMMO AND ARMS / SURPLUS AMMO AND ARMS.COM LAKEWOOD WASHINGTON (HOLDS A VALID FFL PER ATF)
SUS - SURPLUS ARME DESIGN STUDIOS,LLC CHESTER, PENNSYLVANIA
SUV - SURVIVAL ARMS MAKER OF AR-7 RIFLE (POST-1991)
VAW - SUTLIFF ENTERPRISES LLC THE VAULT ARMORY%BOYCEVILLE WISCONSIN
SV - SVALBARD (NORWEIGAN TERRITORY) USE COUNTRY CODE IF MAKE CAN NOT BE DETERMINED
SWT - SWAT FIREARMS CAMPBELL, TX
SQ - SWEDEN USE COUNTRY CODE IF MAKE CAN NOT BE DETERMINED
SWF - SWIFT MFG. CO.
RT - SWINOMISH INDIANS OF THE SWINOMISH RESERVATION, WASHINGTON USE COUNTRY CODE IF MAKE CAN NOT BE DETERMINED
SWA - SWISS ARMS A.G. SWITZERLAND
SZ - SWITZERLAND USE COUNTRY CODE IF MAKE CAN NOT BE DETERMINED
SW0 - SWORD INTERNATIONAL, INC. MCCARRAN, NEVADA
SWB - SWUB ENTERPRISES, INC. (SWUB TACTICAL) DEBARY, FLORIDA
SYC - SYCO DOUBLE HAMMERLESS
SYM - SYMPATHIQUE MFG BY MANUFACTURE D'ARMES DESPYRENEES
SYR - SYRACUSE FORGING CO.SUCCEEDED BY BAKER GUN FORGING CO.
SY - SYRIA USE COUNTRY CODE OF MAKE CAN NOT BE DETERMINED
0BE - SYSTEMA OBREGON MODEL OF OBREGON
TNW - T N W TECHNETWORK VERONIA,OR
TSN - T SQUARED MANUFACTURING, INC. WACO, TX
TAC - T. A. C.
T0C - T0C, INC; DRIPPING SPRINGS, TEXAS
TB - TABASCO USE COUNTRY CODE IF MAKE CAN NOT BE DETERMINED
TCP - TAC PRO SHOOTING CENTER MINGUS, TX
TTC - TAC2 GREENVILLE. TENNESSEE
TXR - TACTIC ENTERPRISE LLC DBA TEXAS AR GEORGETOWN, TX
TEL - TACTIC ENTERPRISE, LLC LIBERTY HILL, TEXAS
TLB - TACTICAL AMBUSH, LLC ORLANDO, FL
TT0 - TACTICAL ARMAMENT COMPANY OGDEN, UTAH
TTL - TACTICAL ARMS OF TEXAS, LLC MISSOURI CITY, TEXAS
TAZ - TACTICAL ARMZ SPRINGFIELD, MO
TCS - TACTICAL COATING SYSTEMS, LLC (TEMPLAR RIFLE COMPANY) SPRINGFIELD, VA
TCL - TACTICAL CUSTOMS LLC CARSON CITY, NEVADA
TDL - TACTICAL DEFENSE SURVIVAL, LLC (TDS MANUFACTURING) ROCKLIN, CA
TFS - TACTICAL FIREARMS SOLUTIONS CLEVELAND, TN
TAG - TACTICAL GRAPHICS,INC.(TGI GUNWORKS) MELBOURNE, FLORIDA
TLI - TACTICAL INNOVATIONS INC., BONNERS FERRY, IDAHO
TLF - TACTICAL LIFE, LLC DAVIE, FL
TLM - TACTICAL MACHINING, LLC; DELAND, FLORIDA
TLL - TACTICAL RESOLVE, LLC GLENNVILLE, GEORGIA
TTZ - TACTICAL RIFLES INC. ZEPHYRHILLS, FLORIDA
TSL - TACTICAL S0LUTI0NS, LLC; B0ISE, ID
TSK - TACTICAL SKELETON DALLAS, TX
TSU - TACTICAL SUPERIORITY, INC MELBOURNE, FL
TSP - TACTICAL SUPPLY ALPHA, LLC AKA TACTICAL SUPPLY YAKIMA, WA
TWS - TACTICAL WEAPONS SOLUTIONS COMPANY, APOPKA, FLORIDA
TCT - TACTICS LLC; SCOTTSDALE, ARIZONA
TAI - TAICO
TW - TAIWAN, REBPUBLIC OF CHINA USE COUNTRY CODE IF MAKE CAN NOT BE DETERMINED
T0J - TAIYO-JUKI MFR OF SHOTGUNS
TJ - TAJIKISTAN USE COUNTRY CODE IF MAKE CAN NOT BE DETERMINED
TLC - TALON ARMAMENT,LLC KENNESAW, GA
TNA - TALON ARMS HOUSTON, TEXAS
TII - TALON INDUSTRIES, INC. ENNIS, MT
TA - TAMAULIPAS USE COUNTRY CODE IF MAKE CAN NOT BE DETERMINED
TZ - TANZANIA, UNITED REPUBLIC OF USE COUNTRY CODE IF MAKE CAN NOT BE DETERMINED
TP0 - TAPCO WEST JORDAN, UT
TTV - TARAN TACTICAL INNOVATIONS, LLC SIMI VALLEY, CALIFORNIA
TSR - TASER FIRES ELECTRICALLY CHARGED DARTS
TAT - TATRA
TAS - TAURUS BRAZIL
TAY - TAYLOR MANUFACTURING; MARIETTA, GEORGIA
TYC - TAYLOR'S & CO. INC. WINCHESTER, VA
TDN - TD INDUSTRIES, LLC (PRECISION RIFLE COMPANY) DORR, MI
RX - TE-MOAK TRIBE OF WESTERN SHOSHONE INDIANS OF NEVADA (FOUR CONSTITUENT BANDS: BATTLE MOUNTAIN BAND; ELKO BAND; SOUTH FORK BAND
TMP - TECHNIARM METAL PRODUCTS
TGN - TECHNICAL GRINDING AND MACHINING INC. BLAINE, MN
TCA - TECHNO ARMS
WID - TED WILLIAMS SOLD BY SEARS NUMBER APPEARING THERE ON POSSIBLY SEARS INVENTORY CONTRAOL NUMBER RATHER THAN UNIQUE SERIAL NUMB
TGS - TED'S GUN SMITHING; DELAND, FLORIDA
TEG - TEGRA ARMS, INC. OREM, UTAH
VKT - TEHDAS
TEI - TEIS
TEM - TEMPLAR ARMAMENT, LLC LOS GATOS, CALIFORNIA
TCF - TEMPLAR CUSTOM FIREARMS; APEX, NORTH CAROLINA
TNR - TEN RING LLC; VALLONIA IN
TEN - TEN STAR IMPORTED BY H & D FOLSOM
TNS - TENNESSEE ARMS COMPANY, LLC DYERSBURG, TN
TN - TENNESSEE USE COUNTRY CODE IF MAKE CAN NOT BE DETERMINED
TMB - TERMINAL BALLISTICS,INC. ORANGE GROVE, TX
TPX - TERMINAL PERFORMANCE RUTHER GLEN, VIRGINIA
TRG - TERRITORIAL GUNSMITH LTD; HOPKINS, MINNESOTA MANUFACTURER OF AR-15 RECEIVERS
T1 - TEST
TEU - TEUF-TEUF-HANDGUN MODEL
TAW - TEXAS ARMORY WACO TEXAS (MAKES DERRINGERS)
TSA - TEXAS AUTOMATICS
TXB - TEXAS BLACK RIFLE CO., INC.; SHINER, TEXAS _ADDED/ASSIGNED 7/18/14
TCG - TEXAS CUSTOM GUNS ALVIN, TX
TLA - TEXAS LONGHORN ARMS RICHMOND TEXAS
TEX - TEXAS RANGER
TSE - TEXAS SESQUICENTENNIAL
TSS - TEXAS SHOOTERS SUPPLY (CUSTOM DESIGNED COMPUTERS, LLC) CONROE,TEXAS
TXM - TEXAS STATE ARMORY KATY, TX
TX - TEXAS USE COUNTRY CODE IF MAKE CAN NOT BE DETERMINED
RAN - TEXAS-RANGER-FRONTIER
TGT - TGC OUTDOORS, LLC (TGC TACTICAL); ABBEVILLE, MISSISSIPPI
TH - THAILAND USE COUNTRY CODE IF MAKE CAN NOT BE DETERMINED
LG0 - THALES AUSTRALIA LIMITED (LITHGOW ARMS) LITHGOW, AUSTRALIA
THA - THAMES ARMS CO.BRAND OF HARRINGTON & RICHARDSON
THY - THAYER, ROBINSON, & CARY
AMY - THE ARMORY GUNS AND AMMO, LLC. PELHAM, AL
AAU - THE ARMOURY, LLC (ARMTAC) ROLAND, AR
TMR - THE ARMS ROOM ORLANDO, FLORIDA
TGR - THE GUN ROOM COMPANY, LLC BELGRADE, MONTANA
TTG - THE GUN STORE (JASON T. WALLACE) CONWAY, SOUTH CAROLINA
MDS - THE MIDSTATES ARMORY, LLC STOVER, MISSOURI
RDL - THE RIDDLE OF STEEL (TROS); DUNDEE, OREGON ADDED/ASSIGNED 7/8/15
RSI - THE RIFLE SPECIALIST, INC. PARROTSVILLE, TN
SGC - THE SPIRIT GUN MANUFACTURING COMPANY, LLC WEST PALM BEACH, FL
TEA - THE TACTICAL EDGE LLC. CLARKSVILLE, TN
TGC - THE TRIANGLE GUN C0; HUNGARY
WEC - THE WEAPONS CASH, NEGAUNEE MI
THF - THEATE FRERES, LIEGE, BELGIUM
THD - THERMAL DEFENSE SOLUTIONS,LLC JONESBOROUGH,TN
TDS - THERMO DYNAMIC SYSTEMS MFG OF HANDGUNS
YR - THLOPTHLOCCO TRIBAL TOWN, OKLAHOMA USE COUNTRY CODE IF MAKE CANNOT BE DETERMINED
T0M - THOMAS ARMS CO.
TPM - THOMPSON MACHINE; PANACEA, FL
TGD - THOR GLOBAL DEFENSE GROUP, INC. VAN BUREN, ARKANSAS
THC - THORDSEN CUSTOMS, LLC SOUTH SAN FRANCISCO, CALIFORNIA
TGH - THOROUGHBRED RIFLES, LLC FRISCO, TEXAS
RZ - THREE AFFILIATED TRIBES OF THE FORT BERTHOLD RESERVATION, NORTH DAKOTA USE COUNTRY CODE IF MAKE CAN NOT BE DETERMINED
THR - THREE BARREL GUN CO.
TG0 - THREE G. ORDNANCE
TBE - THUNDER BEASTS ARMS CORP.(TBAC) CHEYENNE, WY
THT - THUNDER TECHNOLOGIES LLC PORTLAND, OR
TDF - THUREON DEFENSE LLC NEW HOLSTEIN, WI
TBR - TIBERSINGLE-SHOT PISTOLS
TIE - TIER 1, LLC NINE MILE FALLS, WA
TGG - TIGER (SHOTGUN)IMPORTED BY H & D FOLSOM
TFC - TIM LA FRANCE FOUNTAIN VALLEY, CA
TTS - TIMBERWOLF TACTICAL SOLUTIONS (TRADE NAME-TIMBERWOLF DEFENSE) ERWIN, NC
TPA - TIME PRECISION ARMS (TRADE NAME), LICENSE LISTS THEM AS: PRECISION ARMS; NEW MILFORD, CONNECTICUT
TIN - TINGLE
TIP - TIPPMAN ARMS COMPANY HALF SCALE REPRODUCTION OF BROWNING MACHINE GUN 22 CALIBER FORT WAYNE IN
TRX - TIRMAX AUTOMATIC LOADING RIFLE
TIS - TISAN MFG BY SALAVERRIA
TMC - TITAN MANUFACTURING CORP.BOUGHT BY F.I.E. IN 1968
TTR - TITUSVILLE ARMORY TITUSVILLE, FLORIDA
TIW - TIWA
TKS - TKS ENGINEERING CASA GRANDE, AZ
TLT - TL TECHNOLOGIES, INC. (THOMPSON & LEH) LANCASTER, PA
TL - TLAXCALA USE COUNTRY CODE IF MAKE CAN NOT BE DETERMINED
TNI - TNI
T0B - TOBIN ARMS MFG. CO.
T0I - TOBIN SIMPLEX MFGR OF REVOLVERS
TVN - TOBY'S TACTICAL (TOBY VANDERBEEK) MOUNTAIN VIEW,CA
T0 - TOGO USE COUNTRY CODE IF MAKE CAN NOT BE DETERMINED
UB - TOHONO O'ODHAM NATION OF ARIZONA USE COUNTRY CODE IF MAKE CAN NOT BE DETERMINED
TK - TOKELAU (NEW ZEALAND TERRITORY) USE COUNTRY CODE IF MAKE CAN NOT BE DETERMINED
TKA - TOKYO ARSENAL
TGE - TOKYO GAS & ELECTRIC
T0L - TOLEDO FIREARMS CO.
TSM - TOM SAWYER MANUFACTURING, WOODBURY, MN
TBT - TOMMY BUILT TACTICAL LLC GAITHERSBURG, MD
VAS - TOMPKINS MODEL OF VARSITY
UD - TONAWANDA BAND OF SENECA INDIANS OF NEW YORK USE COUNTRY CODE IF MAKE CAN NOT BE DETERMINED
TG - TONGA USE COUNTRY CODE IF MAKE CAN NOT BE DETERMINED
TQ - TONGAREVA USE COUNTRY CODE IF MAKE CAN NOT BE DETERMINED
UE - TONKAWA TRIBE OF INDIANS OF OKLAHOMA USE COUNTRY CODE IF MAKE CAN NOT BE DETERMINED
T0N - TONOLINI-MODE 440 SHOTGUN
UF - TONTO APACHE TRIBE OF ARIZONA USE COUNTRY CODE IF MAKE CAN NOT BE DETERMINED
T00 - TOOLEY CUSTOM RIFLES, LLC ORIENTAL, NC
TNE - TOOTH & NAIL RACING, LLC (ENTERPRISES) GRAVOIS MILLS, MISSOURI
TPN - TOP NOTCH ACCESSORIES, INC. (OMEGA) RUSSELLVILLE, ARKANSAS
TSC - TOP SNAP CHAMPION BRAND OF GREAT WESTERN ARMS CORP
T0R - TORKELSON ARMS CO.MFR. OF SHOTGUNS
T0P - TORPILLE
T0T - TORTORT MANUFACTURING SANTA ANA, CA
TUN - TORUN FIREARMS, TORUN SILAH SAN LTD STI, TURKEY
TWR - TOWER BROWN BESS PRE REVOLUTIONARY WAR, BRITISH MILITARY WEAPONS PLANT
TPL - TPM ARMS, LLC EL CAJON, CALIFORNIA
TTF - TPM OUTFITTERS CARROLLTON, TEXAS
TBZ - TRABZON ''TISAS''; TURKEY (IMPORTER-AMERICAN TACTICAL) TISAS TRABZON SILAH SANAYI-C45, CS9, FS9, HP9 (MODELS)
TKP - TRACKINGPOINT INC. PFLUGERVILLE, TX
TRD - TRADE
TRW - TRADEWINDS IMPORTER ONLY-CODE FOR MFGR IF KNOWN
TDP - TRADING PLACE PAWN & INDOOR GUN RANGE MONROE, GA
TDI - TRADITIONS, INC.IMPORTERS OF SPANISH BLACK-POWDERFIREARMS
TRF - TRAFF
TBF - TRAILBLAZER FIREARMS, LLC ASHEVILLE, NORTH CAROLINA
TFD - TRANSFORMATIONAL DEFENSE INDUSTRIES, INC (TDI)/KRISS USA INC.FORMERLY (TRANSFORMATIONAL DEFENSE INDUSTRY)
TRE - TRANTER, WILLIAM
TRA - TRAPS BEST
TRC - TRC
TRJ - TREJO
TRR - TRENT METAL INDUSTRIES
TSF - TRESNA DEFENSE (TAC-GRIP, LLC) DALLAS, GA
TTU - TRESSITU
TRK - TRIARC SYSTEMS, LLC BELTON, TEXAS
TRQ - TRICO
TDT - TRIDENT ARMS. LLC; TAMPA, FLORIDA
TTT - TRIDENTIS TACTICAL LA MESA, CA
TT - TRINIDAD & TABAGO USE COUNTRY CODE IF MAKE CAN NOT BE DETERMINED
TR0 - TRIOMPHEMFD. BY APALOZO
TTJ - TRIPLE J ARMORY, INC. LITTLETON, COLORADO
TPE - TRIPLE-S DEVELOPMENT CO.
TRV - TRIPLETT & SCOTT
TRS - TRIPP RESEARCH MAKER PLASTIC REPLACEMENT FRAMES FOR COLT 1911 STYLE PISTOLS
TPR - TRIPP RESEARCH, INC. (COBRATRIPP CUSTOM) BASTROP, TX
LTD - TRIPP WIRE, LLC DBA LIMITED 10 SAN DIEGO, CA
TRI - TRISTAR (TRI-STAR) SPORTING ARMS, MISSOURI
TAM - TRITON ARMS LLC. YUMA, AZ
TTX - TRITON MFG, INC. VIRGINIA BEACH, VIRGINIA
TSD - TRIUMPH SPORTS DISTRIBUTOR
TTM - TRIUNE ARMS, LLC WARRENTON, VIRGINIA
TRL - TROCAOLA, ARANZABAL
TRN - TROJAN FIREARMS, LLC PHOENIX, AZ
TM - TROMELIN ISLAND (FRENCH POSSESSION) USE COUNTRY CODE IF MAKE CAN NOT BE DETERMINED
TYD - TROY DEFENSE / TROY INDUSTRIES; SPRINGFIELD, MA TROY DEFENSE LISTED AS TRADE NAME ON LICENSE
TRT - TRU-TEST
TD - TRUST TERRITORY OF THE PACIFIC ISLANDS USE COUNTRY CODE IF MAKE CAN NOT BE DETERMINED
TV0 - TRUVELO ARMORY, SOUTH AFRICA
TMS - TS ARMS PELHAM, AL
TS - TS MODEL OF SHOTGUN NEVIS & ST CHRISTOPHER OR ST KITTS USE COUNTRY CODE IF MAKE CAN NOT BE DETERMINED
TSI - TSUNAMI ARMS, LLC FOUNTAIN HILLS, AZ
TTN - TTI INTERNATI0NAL; GLEN ALLEN VIRGINIA
TTI - TTIBAR PISTOLA
TF - TUAMOTU ARCHIPELAGO USE COUNTRY CODE IF MAKE CAN NOT BE DETERMINED
TUE - TUE-TUE
UH - TULALIP TRIBES OF THE TULALIP RESERVATION, WASHINGTON USE COUNTRY CODE IF MAKE CAN NOT BE DETERMINED
UI - TUNICA-BILOXI INDIAN TRIBE OF LOUISIANA USE COUNTRY CODE IF MAKE CAN NOT BE DETERMINED
TU - TUNISIA USE COUNTRY CODE IF MAKE CAN NOT BE DETERMINED
TY - TURKEY USE COUNTRY CODE IF MAKE CAN NOT BE DETERMINED
UR - TURKMENISTAN USE COUNTRY CODE IF MAKE CAN NOT BE DETERMINED
TR - TURKS & CALCOS ISLANDS (DEPENDENT TERRITORY OF UNITED KINGDOM)USE COUNTRY CODE IF MAKE CAN NOT BE DETERMINED
TBM - TURNBULL MANUFACTURING CO. BLOOMFIELD, NEW YORK
TUL - TURNER ARMAMENT LLC HICKORY, NC
TUR - TURNER FABRICATIONS, LLC MESA, ARIZONA
TTA - TURNER'S TACTICAL ARMS, LLC ST. CLAIR, MI
UC - TURTLE MOUNTAIN BAND OF CHIPPEWA INDIANS OF NORTH DAKOTA USE COUNTRY CODE IF MAKE CAN NOT BE DETERMINED
UJ - TUSCARORA NATION OF NEW YORK USE COUNTRY CODE IF MAKE CAN NOT BE DETERMINED
TV - TUVALU (FORMERLY ELLICE ISLANDS) USE COUNTRY CODE IF MAKE CANNOT BE DETERMINED
TWH - TWH ENTERPRISES, LLC BATESVILLE, AR
TWP - TWIN PINES, PHILIPPINES
TWT - TWISTED RIVER TACTICAL, LLC CANAL FULTON, OH
TVA - TWO RIVERS ARMS, LLC; OKLAHOMA CITY, OK
TYF - TYLER FIREARMS, LLC (ARIMUS TACTICAL) HALETHORPE, MD
TYP - TYPHOON DEFENCE INDUSTRIES%OZERBAS MAKINA SILAH KONYA TURKEY
TYY - TYR DEFENSE INDUSTRIES, LLC CARTERSVILLE, GA
TYR - TYROL (RIFLE)EARLY NAME FOR VOERE, ALSO SEEDUMOULIN
UAE - U. A. E. (UNION ARMERA EIBAR)
UPA - U.P. IN ARMS LLC SAULT SAINTE MARIE, MI
USL - U.S. ARMS & CUTLERY CO.
USR - U.S. ARMS, LLC LAKE HAVASU CITY, ARIZONA
UFA - U.S. FIREARMS ACADEMY AKA RENO GUNS RENO, NEVADA
US0 - U.S. ORDNANCE SPARKS, NV
URA - U.S. REPEATING ARMS COMPANY, NEW HAVEN, CT. (TRADE NAME-USRA) ASSOCIATED WITH WINCHESTER ARMS CO.
UTC - U.S. TACTICAL ARMS, CORP; OTTUMWA, IOWA
VI - U.S. VIRGIN ISLANDS USE COUNTRY CODE IF MAKE CAN NOT BE DETERMINED
USA - U.S.MILITARY ISSUED WEAPONS%INCLUDES SPRINGFIELD MILITARY WEAPONS
UDZ - UCYILDIZ ARMS IND. CO., LTD ALSO AKDAL ARMS; TURKEY
UG - UGANDA USE COUNTRY CODE IF MAKE CAN NOT BE DETERMINED
UK - UKRAINE USE COUNTRY CODE IF MAKE CAN NOT BE DETERMINED
ULY - ULTIMATE ACCURACY LONOKE, AR 50 CALIBER RIFLE
UUA - ULTIMATE ARMS, LLC GALLATIN, TN
ULT - ULTRA HI
ULA - ULTRA LIGHT ARMS-GRANVILLE WV
UTN - ULTRA TECH INC DBA U T ARMS KANSAS CITY, KS
USG - ULTRAMATIC SPORTWAFFEN G.M.B.H.
UMX - UMAREX SPORTWAFFEN GMBH & CO. KG. ARNSBERG, GERMANY
UMB - UMBRELLA CORPORATION, WRG VIRGINIA BEACH, VIRGINIA
UMA - UMLAUT INDUSTRIES, LLC (TRADE NAME-UMLAUT ARMS) CONCORD, NH
UNC - UNCLE SAM
UGS - UNDERGROUND SKUNKWORKS COLUMBIA FALLS, MT.
UNT - UNDERGROUND TACTICAL ARMS COMPANY AUSTIN, TEXAS
U0C - UNERTL ORDNANCE CO.INC.LAS VEGAS, NEVADA
USC - UNION SALES CO.
UNA - UNION VARIOUS MFRS
UNN - UNION/UNION I
UNU - UNIQUE
UQA - UNIQUE ALPINE AUSTRIA
UNS - UNIS
TC - UNITED ARAB EMIRATES (FORMERLY TRUCIAL STATES) USE COUNTRY CODE IF MAKE CANNOT BE DETERMINED
XL - UNITED KEETOOWAH BAND OF CHEROKEE INDIANS OF OKLAHOMA USE COUNTRY CODE IF MAKE CANNOT BE DETERMINED
UN - UNITED KINGDOM (ALSO SEE ENGLAND EN, SCOTLAND SS, WALES WL, NONORTH IRELAND USE COUNTRY CODE IF MAKE CAN NOT BE DETERMINED. G
UST - UNITED STATES ARMS CORP.
ZZZ - UNKNOWN SEE NCIC OPERATING MANUAL; PART 4 SECTION 2 CONTACT CJIS LAW ENFORCEMENT SUPPORT SECTION
US - UNKNOWN%AND MANUFACTURED IN THE USA BUT NOT MILITARY-ISSUED
UPD - UPLANDER SHOTGUN MODEL
YS - UPPER SIOUX COMMUNITY, MINNESOTA USE COUNTRY CODE IF MAKE CAN NOT BE DETERMINED
UL - UPPER SKAGIT INDIAN TRIBE OF WASHINGTON USE COUNTRY CODE IF MAKE CAN NOT BE DETERMINED
URK - URKO MFG OF RIFLES AND SHOTGUNS
URE - URREJOLA
UY - URUGUAY USE COUNTRY CODE IF MAKE CAN NOT BE DETERMINED
UCC - US ACCURACY AND BRASS, LLC DUCHESNE, UT
USW - US AUTOWEAPONS, LLC SCOTTSDALE, ARIZONA
USF - US FIREARMS MFG. CO. AKA UNITED STATES PATENT FIREARMS AKA ZIP FACTORY AKA USFA OR UNITED STATES FIRE-ARMS MFG., INC. HARTFO
UMG - US MACHINE GUN ARMORY (MACHINE GUN ARMORY, LLC) SANDY, UT
PSF - US PRECISION FIREARMS AVENUE, MD
UTF - USA TACTICAL FIREARMS, LLC STATESVILLE, NORTH CAROLINA
USE - USELTON ARMS, MADISON, TENNESSEE
UT - UTAH USE COUNTRY CODE IF MAKE CAN NOT BE DETERMINED
UTA - UTAS (FOUND ON GUN) TURKEY PER ATF, UTAS-USA, MAK CODE UTU ISASSOCIATED WITH UTAS-TURKEY
UTU - UTAS-USA DES PLAINES, ILLINOIS PER ATF, UTAS-TURKEY, MAK CODEUTA IS ASSOCIATED WITH UTAS-USA
UP - UTE MOUNTAIN TRIBE OF THE UTE MOUNTAIN RESERVATION, COLORADO, NEW MEXICO AND UTAH USE COUNTRY CODE IF MAKE CAN NOT BE DETERMI
UTI - UTICA
UZ - UZBEKISTAN, REPUBLIC OF USE COUNTRY CODE IF MAKE CAN NOT BE DETERMINED
UZI - UZI SEMI AUTOMATIC, INPORTED BY ACTION ARMS PHILADELPHIA PA
UZU - UZUMLU ARMS
VSW - V7 WEAPON SYSTEMS, LLC GLENDALE, OREGON
VAI - VAINQUEUR
VAL - VALIANT/VALIANT RIFLE VARIOUS MFGS
VAK - VALKYRIE ARMS MILPITAS, CALIFORNIA NOT SAME AS VALKYRIE ARMS;ELMA, WASHINGTON
VLK - VALKYRIE ARMS, LTD.; ELMA, WA NOT SAME AS VALKYRIE ARMS MILPITAS CALIF
VAA - VALLEY ARMORY, LLC PALMER, ALASKA
V0W - VALLEY ORDNANCE WORKS, LLC PEORIA, ARIZONA
V0I - VALLEY ORDNANCE, INC.MFD. FOR SPRINGFIELD ARMORY, TX
VSS - VALLEY STEEL STAMP INC, GREENFIELD, MA
VA0 - VALOR IMPORTER OF EMGE AND ROHM
VT0 - VALTRO CARCINA IT MFGR OF SHOTGUNS
RBS - VALUE CANS, LLC (REBEL SILENCERS) EL PASO, TEXAS
VAN - VANDALIS
HN - VANUATU, REPUBLIC OF (FORMERLY NEW HEBRIDES) USE COUNTRY CODE IF MAKE CAN NOT BE DETERMINED
VAR - VARMETER
VRM - VARNER ARMS; 0AK HARB0R WASHINGT0N
VSP - VASP (VISSER ASSAULT PISTOL)MFD. BY HARWICK AIR CONTROLS
VY - VATICAN CITY USE COUNTRY CODE IF MAKE CAN NOT BE DETERMINED
VCD - VC DEFENSE THOUSAND OAKS, CALIFORNIA
VDC - VDC ARMORY, LLC (VICTORY DEFENSE CONSULTING) CANON CITY, COLORADO
VRA - VECT0R ARMS; SALT LAKE CITY UTAH; NOT TO BE CONFUSED WITH VEKTON IN SOUTH AFRICA
VEA - VEDETTSEE ROUBY
VGA - VEGA DISTRIBUTED BY PIC AND EDDY MFG. CO
VTR - VEKTOR PRETORIA,SA
VLL - VELLA ENTERPRISES, LLC (VELLA INDUSTRIES) MILPITAS, CA
VEB - VELOBROM
VCF - VELOCITY FIREARMS; DULUTH, MINNESOTA
VAT - VELOCITY, LLC (ATLANTIC ARMS MFG) DULUTH, MINNESOTA
VEI - VELOMITH
VZ - VENEZUELA, REPUBLIC OF USE COUNTRY CODE IF MAKE CAN NOT BE DETERMINED
VC - VERACRUZ USE COUNTRY CODE IF MAKE CAN NOT BE DETERMINED
VNT - VERCHRMONT
VER - VERGO
VRT - VERITAS TACTICAL, LLC ORLANDO, FL
VT - VERMONT USE COUNTRY CODE IF MAKE CAN NOT BE DETERMINED
VCU - VERNEY CARRON USA,INC. CLAY CENTER, KANSAS
VNA - VERONA; ITALY
VN0 - VETERAN OUTDOORS LEXINGTON, TN
VET - VETTERLI MILITARY WEAPONS-SWITZERLAND
VII - VICI
VIK - VICKERS-ARMSTRONG.30 CALIBER MACHINE GUNS
VI0 - VICTOR VARIOUS MFGRS
VXX - VICTRIX ARMAMENTS%CAZZANA SANT'ANDREA BG ITALY OWNED BY BERETTA
VPS - VIDALIA POLICE SUPPLY (KAVOD CUSTOMS, LLC)VIDALIA,GEORGIA
VRI - VIGILANCE RIFLES INC. CHINO VALLEY, AZ
VKI - VIKING ARMAMNET, INC. GRAND JUNCTION, COLORADO
VIL - VILAR
WNE - VILLIN INDUSTRIES, INC. (WARRIOR ONE) RIVERSIDE, CALIFORNIA
VNC - VINCETA Y CIA
V0C - VINTAGE ORDNANCE COMPANY DBA VOCO ELIZABETHTOWN, KY.
VPF - VIPER NORTHWEST (VIPER FIREARMS) ALBANY, OREGON
VIP - VIPER SEE BABY HAMMERLESS
VTA - VIPER TACTICAL ARMS, LLC O'BRIEN, OR
VVC - VIRGIN VALLEY CUST0M GUNS; HURRICANE, UTAH
VA - VIRGINIA USE COUNTRY CODE IF MAKE CAN NOT BE DETERMINED
VIZ - VISION ARMORY, LLC (VISION DEFENSE) MIDDLEBURY, INDIANA
VKS - VK INTEGRATED SYSTEMS FULLERTON, CALIFORNIA
VWS - VLTOR WEAPONS SYSTEMS TUCSON, AZ
VMH - VM HY-TECH LLC; PHOENIX, ARIZONA
VRE - VOERE-AUSTRIA (SEPERATED OUT FROM-VOERE VOEBRENBACH; MAK/VOE MFG IN GERMANY PER ATF 4/23/10
V0E - VOERE VOEHRENBACH-GERMAN COMPANY 2ND COMPANY WITH SAME NAME VOERE IN AUSTRIA MAK/VRE-ASSIGNED 4/23/10 PER ATF
VL - VOL BRAND NAME OF BLUMENFIELD IMPORTS NAVASSA ISLAND USE COUNTRY CODE IF MAKE CAN NOT BE DETERMINED
VLC - VOLCANIC MODEL OF STARTER GUN
V0R - VOLCANIC REPEATING ARMS CO.
VKC - VOLKMANN CUSTOM INC; LAKEWOOD, COLORADO
VNN - VOLKMANN PRECISION, LLC LITTLETON, COLORADO
VCL - VOLQUARTSEN CUSTOM LTD
VEK - VOLTRAN AV SILAHLARI, LTD; TURKEY
VRN - VORENBACH MFGR OF RIFLES
VRU - VORN SURVIVAL, LLC (VORN-USA) LAYTON, UTAH
VDV - VORTEC DEVELOPMENT (SABERTOOTH DEFENCE SYSTEMS) ERWIN, NC
VGW - VUDOO LABS INC. (VUDOO GUN WORKS) SAINT GEORGE, UT
VUC - VULCAIN
VCN - VULCAN ARMS INC. INVERGR0VE HEIGHTS, IL
VLN - VULCAN MFG BY PFANNI
VUR - VURSAN; ISTANBUL, TURKEY
MLT - VYATSKIE POLYANY MACHINE BLDG PLANT (AKA MOLOT)
WJJ - W J JEFFERY & COMPANY, LTD.; ENGLAND
WDI - WADCO INDUSTRIES, LLC; MELBOURNE, FLORIDA
WFR - WAFFEN FRANCONIA
WFW - WAFFEN WERKS KNOXVILLE, TN
WTK - WAFFEN-TECHNIK (GERMANY)
WK - WAKE ISLAND USE COUNTRY CODE IF MAKE CAN NOT BE DETERMINED
WAF - WALCH FIREARMS CO.
WL - WALES OR UN FOR UNITED KINGDOM USE COUNTRY CODE IF MAKE CAN NOT BE DETERMINED
WLK - WALKER
UQ - WALKER RIVER PAIUTE TRIBE OF THE WALKER RIVER RESERVATION, NEVADA USE COUNTRY CODE IF MAKE CAN NOT BE DETERMINED
WF - WALLIS & FUTUNA (FRENCH TERRITORY) (FRENCH OVERSEAS TERRITORY)USE COUNTRY CODE IF MAKE CAN NOT BE DETERMINED
WAL - WALTHER ARMS
UU - WAMPANOAG TRIBE OF GAY HEAD (AQUINNAH) OF MASSACHUESETTS USE COUNTRY CODE IF MAKE CAN NOT BE DETERMINED
WSI - WAR SPORT INDUSTRIES, LLC; ROBBINS, NORTH CAROLINA
WBN - WARD BURTON MFGR OF CIVIL WAR RIFLES
WRH - WARHORSE INDUSTRIES LLC BEACH CITY, TX
WAE - WARNER-COUNET
WA0 - WARREN ARMS CORP.IMPORTED BY H & D FOLSOM
WRM - WARRIOR ARMS, LLC VALPARAISO, INDIANA
WPF - WARRIOR HOLDINGS, LLC (PETERSON FARMS) MUSKEGO, WISCONSIN
WAS - WARRIOR PISTOLS IMPORTED BY LASZIO
WA - WASHINGTON USE COUNTRY CODE IF MAKE CAN NOT BE DETERMINED
UW - WASHOE TRIBE OF NEVADA & CALIFORNIA (CARSON COLONY, DRESSLERVILLE COLONY, WOODFORDS COMMUNITY, STEWART COMMUNITY, AND WASHOE 
WSN - WATS0N BR0THERS; L0ND0N, ENGLAND
WAU - WAUTAUGA
WDD - WDD INVESTMENTS, INC. (MOCKINGBIRD PRECISION) HOUSTON, TEXAS
WEP - WEAPONCRAFT, LLC; PORTLAND, MAINE
WER - WEAVER ARMS
WBA - WEB ARMS; PASADENA, TX
WEF - WEBLEY-FOSBERY AUTOMATIC REVOLVERS
WI - WEDMER WISCONSIN USE COUNTRY CODE IF MAKE CAN NOT BE DETERMINED
WEL - WEGRIA-CHARLIER
WE - WEHER WHITE EARTH BAND OF CHIPPEWA, MINNESOTA USE COUNTRY CODE IF MAKE CAN NOT BE DETERMINED
WDM - WEI D0NG MANUFACTURING; CHINESE
WFS - WEIDNER CONSULTING, LLC (FIRST STRIKE MUNITIONS) FREDERICKSBURG, VA
WW - WEINER WAFFENFABRIK
WCG - WELLS CUSTOM GUNS, LLC, NICHOLSON, PA
WEG - WERDER LIGHTNING
WKZ - WERKZEUGBAU; WERKZEUGBAU WIESA; VEB GERATE- UND WERKZEUGBAU
WRL - WERNDL
W0D - WESCO ORDNANCE, DIVISION OF B-C
WEH - WESSON & HARRINGTON
WLT - WESSON & LEAVITT MFGR OF CIVIL WAR REVOLVERS
WEM - WESSON, STEVENS, & MILLER
WB - WEST BANK USE COUNTRY CODE IF MAKE CAN NOT BE DETERMINED
WCW - WEST COAST WEAPON WORKS,LLC SAN DIEGO,CA
WFA - WEST FORK ARMORY, LLC CONROE, TEXAS
WGF - WEST GEORGIA FIREARMS, LLC (FULL METAL JACKET) LAGRANGE, GEORGIA
WN - WEST INDIES (FOR WEST INDIES ISLANDS NOT FOUND SEPARATELY LISTED) USE COUNTRY CODE IF MAKE CAN NOT BE DETERMINED
WRR - WEST RIVER RIFLE COMPANY, LLC (MACK BROTHERS) STURGIS, SD
WT0 - WEST TEXAS ORDINANCE ACKERLY,TX
WV - WEST VIRGINIA USE COUNTRY CODE IF MAKE CAN NOT BE DETERMINED
WAC - WESTERN ARMS CORP.
XM - WESTERN DELAWARE TRIBE, OKLAHOMA (NOW DELAWARE NATION, OKLAHOMOKLAHOMA USE COUNTRY CODE IF MAKE CANNOT BE DETERMINED
WEN - WESTERN MARSHAL MFG BY SAUER AND VARIOUS OTHER MFGRS
RS - WESTERN SAHARA, INDEPENDENT STATE OF (FORMERLY SPANISH SAHARA)USE COUNTRY CODE IF MAKE CAN NOT BE DETERMINED
WEV - WESTERN VALLEY ARMS
WHP - WHIPPET-VARIOUS MFGRS
UX - WHITE MOUNTAIN APACHE TRIBE OF THE FORT APACHE RESERVATION, ARIZONA USE COUNTRY CODE IF MAKE CAN NOT BE DETERMINED
WHE - WHITNEYVILLE ARMORY
WTW - WHITWORTH RIFLE CO.
WNT - WICHESTER
WT - WICHITA AND AFFILIATED TRIBES, OKLAHOMA (WICHITA, KEECHI, WACO AND TAWAKONIE) USE COUNTRY CODE IF MAKE CAN NOT BE DETERMINED
WHT - WICHITA CLASSIC (WICHITA ARMS, INC) BOLT ACTION RIFLES AND PISTOLS
WWL - WICKED WEAPONRY, LLC HOOKSETT, NEW HAMPSHIRE
WWF - WIENER WAFFENFABRIK
WWG - WILD WEST GUNS, LLC ANCHORAGE, ALASKA
WBT - WILDE BUILT TACTICAL, LLC LA MESA, CALIFORNIA
WIY - WILDEY FIREARMS COMPANY WINSTON, NJ
WIP - WILKAR PRODUCTS, INC.
WKA - WILKEYS ADVANCED ARMAMENTS DAYTON, TN
WKS - WILKINSON & SONS ALSO SEE WEBLEY
WMM - WILL-MOR MANUFACTURING, INC. SEABROOK, NEW HAMPSHIRE
WFD - WILLIAM FORD; BIRMINGHAM ENGLAND STARTED 1880'S LATER KNOWN ASAS:ECLIPSE GUN WORKS; MERGED WITH JAMES CARR & SONS IN 1946 WI
WLS - WILLIAM LEECH & SON; ENGLAND
WMS - WILLIAMS ARMS COMPNAY; SISTERS, OREGON
WLM - WILMONT ARMS CO.IMPORTED BY H & D FOLSOM
WHQ - WILSHIRE ARMS CO.
WLC - WILSON COMBAT BERRYVILLE, AR
CBK - WILSON PRECISION ARMS INC. DBA COBALT KINETICS SAINT GEORGE, UT
WTL - WILSON TACTICAL LLC; BERRYVILLE, ARKANSAS; ASSOCIATED WITH WILSON COMBAT BUT HAVE SEPERATE LICENSE.
WIS - WILTSHIRE ARMS CO.IMPORTED BY H & D FOLSOM
WIN - WINCHESTER REPEATING ARMS MORGAN, UT
WIR - WINCO ARMS CO.
WWI - WINDHAM WEAPONRY INC. AKA WWI WINDHAM, ME
WNC - WINFIELD ARMS CO.IMPORTER ONLY
WII - WINFIELD ARMS CO.SHOTGUNS MADE BY CRESCENT
WIF - WINFIELD PISTOLS ONLY
WNK - WINKLER-FERLACK MFG IN GERMANY
VD - WINNEBAGO TRIBE OF NEBRASKA USE COUNTRY CODE IF MAKE CAN NOT BE DETERMINED
YV - WINNEMUCCA INDIAN COLONY OF NEVADA USE COUNTRY CODE IF MAKE CANNOT BE DETERMINED
WIL - WINSLOW ARMS CO.LONG GUNS
WIC - WISCHO (K. G. WILSKER & CO.)IMPORTER
WLL - WISCONSIN TACTICAL, LLC WAUKESHA, WISCONSIN
WSS - WISE ARMS, LLC LECOMPTE, LOUISIANA
WLF - WISE LITE ARMS, INC., BOYD, TEXAS
WTP - WITNESS P; GREY GHOST MODEL
WIT - WITTE'S IXL
WMD - WMD GUNS, LLC; STUART, FLORIDA
W0F - WOLF
WWR - WOLFF, ABBOTT AND REINHEIMER, LLC (WAR SYSTEMS) SAINT LOUIS, MISSOURI
WMA - WORKING MAN'S ARMORY, LLC MOUNT PLEASANT, SOUTH CAROLINA
WWA - WORLDWIDE AEROS CORP.MONTEBELLO, CA
WFM - WORLDWIDE FIREARMS MANUFACTURING, INC. GULFPORT, MISSISSIPPI
W0R - WORTHINGTON ARMS CO.MFD. BY CRESCENT & VARIOUS OTHERMFRS.
WAZ - WRAITH ARMS RESOLUTIONS, LLC VELPEN, INDIANA
WUR - WURFFLEIN MFGR OF RIFLES
VE - WYANDOTTE NATION, OKLAHOMA USE COUNTRY CODE IF MAKE CANNOT BE DETERMINED
WD - WYANDOTTE TRIBE, OKLAHOMA USE COUNTRY CODE IF MAKE CAN NOT BE DETERMINED
WY0 - WYO ARMS, LLC CHEYENNE, WYOMING
WYA - WYOMING ARMS
WY - WYOMING USE COUNTRY CODE IF MAKE CAN NOT BE DETERMINED
WBP - WYTWORNIA BRONI JACEK POPINSKI (WBP) ROGOW, POLAND
XPL - X-PLORACO OF TEXAS, INC.AUTOMATIC WEAPONS
XSD - XIN SHAI DAI; CHINESE
XLC - XLCR VARIOUS MFGRS
XMA - XMAD ARMS, INC. SWIFTWATER,PENNSYLVANIA
XPI - XPI ARMORY, LLC MCKINNEY, TX
XGW - XTREME GUN WORX LLC, EMMAUS,PA
XMM - XTREME MACHINING, LLC GRASS FLAT, PENNSYLVANIA
VF - YAKAMA NATION WASHINGTON USE COUNTRY CODE IF MAKE CANNOT BE DETERMINED
VG - YAKTON SIOUX TRIBE OF SOUTH DAKOTA USE COUNTRY CODE IF MAKE CAN NOT BE DETERMINED
YJS - YAMAMOTO JUHO SEISAKUSHO MFR OF SHOTGUNS
YHM - YANKEE HILL MACHINE CO.INC.NORTH HAMPTON, MA
YA0 - YATO MFG BY HAMADA ARSENAL
VH - YAVAPAI-APACHE NATION OF THE CAMP VERDE INDIAN RESERVATION, ARIZONA USE COUNTRY CODE IF MAKE CAN NOT BE DETERMINED
VJ - YAVAPAI-PRESCOTT TRIBE OF THE YAVAPAI RESERVATION, ARIZONA USE COUNTRY CODE IF MAKE CAN NOT BE DETERMINED
RY - YEMEN, REPUBLIC OF USE COUNTRY CODE IF MAKE CAN NOT BE DETERMINED
VK - YERINGTON PAIUTE TRIBE OF THE YERINGTON COLONY AND CAMPBELL RANCH, NEVAD USE COUNTRY CODE IF MAKE CAN NOT BE DETERMINED
YLZ - YILDIZ SANAYI; BURDUR, TURKEY; SH0TGUN ETC. _(YILDIZ SHOTGUN INDUSTRIES)
V0 - YOMBA SHOSHONE TRIBE OF THE YOMBA RESERVATION, NEVADA USE COUTNRY CODE IF MAKE CAN NOT BE DETERMINED
YKA - YORK ARMS HOLLIS, ME
Y0K - YORK CUTLERY IMPORTER OF ARMALITE AN EMGE
Y0R - YORK VARIOUS MFGRS
YA - YOUNG AMERICA IMPORTED BY GEPRGE E ROSE CO
YMI - YOUNG MANUFACTURING INC. PHOENIX AZ
Y0V - YOVANOVITCH
YW - YSLETA DEL SUR PUEBLO OF TEXAS USE COUNTRY CODE IF MAKE CAN NOT BE DETERMINED
YU - YUCATAN USE COUNTRY CODE IF MAKE CAN NOT BE DETERMINED
YG - YUGOSLAVIA CODE BY COUNTRY IF MAKE CANNOT BE DETERMINED
YT - YUKON (TERRITORY) USE COUNTRY CODE IF MAKE CANNOT BE DETERMINED
ZAP - Z AUT. PISTOLE
ZMW - Z M WEAPONS BERNARDSTON,MA
ZB - Z-B MARTINIQUE USE COUNTRY CODE IF MAKE CAN NOT BE DETERMINED
ZA - ZACATECAS USE COUNTRY CODE IF MAKE CANNOT BE DETERMINED
ZAF - ZAFER ARMS COMPANY, TURKEY
ZR - ZAIRE, REPUBLIC OF (FORMERLY CONGO KINSHASA) USE COUNTRY CODE IF MAKE CAN NOT BE DETERMINED
ZAK - ZAK ARMORY PASO ROBLES, CALIFORNIA
ZAM - ZAMACOLA HERMANOS
ZM - ZAMBIA, REPUBLIC OF USE COUNTRY CODE IF MAKE CANNOT BE DETERMINED
ZAS - ZASTAVA (ZAVODI CREVENA) YUGOSLAVIA & SERBIA
ZAV - ZAVADY JANA SVERMY MFR OF SHOTGUNS
ZAI - ZAVIAR,LLC (T6 FIREARMS)LONGWOOD,FLORIDA
ZAY - ZAYREUSE ONLY WHEN MFR. IS UNKNOWN
ZEB - ZEBRA
ZZL - ZEL CUSTOM MANUFACTURING, LLC TAMPA, FL
ZEL - ZELLA
ZIA - ZEROED IN ARMORY,LLC PEARLAND,TX
ZEV - ZEV TECHNOLOGIES OXNARD, CA
ZZM - ZH0NGZH0U MACHINE W0RKS; CHINA
ZIG - ZIJIANG MACHINERY COMPANY CHINA
ZMM - ZIMMERMAN ARMS PRESCOTT, AZ
ZMD - ZOMBIE DEFENSE; GLEN ALLEN, VIRGINIA
Z0U - ZOUAVE
ZRT - ZR TACTICAL SOLUTIONS, LLC NOBLESVILLE, INDIANA
ZUU - ZULU ARMOURY, INC. DORAL, FLORIDA
ZLU - ZULU SINGLE-SHOT SHOTGUNS
YX - ZUNI TRIBE OF THE ZUNI RESERVATION, NEW MEXICO USE COUNTRY CODE IF MAKE CAN NOT BE DETERMINED
ZVI - ZVI ZBROJOVKA VSETIN-INDET CZECHOSLOVAKIA
