|<BLANK>
AL - Alabama
AK - Alaska
AZ - Arizona
AR - Arkansas
CA - California
CO - Colorado
CT - Connecticut
DE - Delaware
DC - District of Columbia
FL - Florida
GA - Georgia
HI - Hawaii
ID - Idaho
IL - Illinois
IN - Indiana
IA - Iowa
KS - Kansas
KY - Kentucky
LA - Louisiana
ME - Maine
MD - Maryland
MA - Massachusetts
~MI - Michigan
MN - Minnesota
MS - Mississippi
MO - Missouri
MT - Montana
NE - Nebraska
NV - Nevada
NH - New Hampshire
NJ - New Jersey
NM - New Mexico
NY - New York
NC - North Carolina
ND - North Dakota
OH - Ohio
OK - Oklahoma
OR - Oregon
PA - Pennsylvania
RI - Rhode Island
SC - South Carolina
SD - South Dakota
TN - Tennessee
TX - Texas
UT - Utah
VT - Vermont
VA - Virginia
WA - Washington
WV - West Virginia
WI - Wisconsin
WY - Wyoming
AM - American Samoa  
BK - Baker Island  
CZ - Canal Zone  
CG - Caroline Islands  
GM - Guam  
HO - Howland Island  
JR - Jarvis Island  
JI - Johnston Atoll  
KI - Kingman Reef  
MK - Mariana Islands  
MH - Marshall Islands  
MW - Midway Islands  
VL - Navassa Island  
MK - Northern Mariana Islands  
PL - Palmyra Atoll  
PR - Puerto Rico  
VI - Virgin Islands  
WK - Wake Island  
;Addtl "state" values
NL - Multi-State Query Functionality
CL - U.S. Commercial Driver's License  
XC - Bad River Band of Lake Superior Tribe of Chippewa Indians
XP - Bois Forte Band of Chippewa
XD - Caddo Tribe
XE - Cherokee Nation
DW - Citizen Potawatomi Nation
XF - Delaware Nation
XG - Eastern Shawnee Tribe
XO - Grand Portage Band of Lake Superior Chippewa
XH - Modoc Tribe
XI - Ottawa Tribe
XJ - Peoria Tribe
XK - Quapaw Tribe
RL - Red Lake Band of Chippewa
XL - United Keetoowah Band of Cherokee Indians
XM - Western Delaware Tribe
WE - White Earth Band of Chippewa
US - U.S. Government
AB - Alberta
BC - British Columbia
CN - All Provinces
MB - Manitoba
MX - Mexico
NK - New Brunswick
NF - Newfoundland
NS - Nova Scotia
ON - Ontario
PE - Prince Ed. Island
PQ - Quebec
SN - Saskatchewan
NT - Northwest Territory
XN - Namavut Providence
YT - Yukon Territory
A1 - Region (CT,MA,ME,NH,RI,VT)
B1 - Region (DE,MD,NJ,NY,PA)
C1 - Region (KY,NC,SC,TN,VA,WV)
D1 - Region (AL,AR,FL,GA,LA,MS)
E1 - Region (IL,IN,MI,MO,OH,WI)
F1 - Region (IA,MN,MT,ND,NE,SD,WY)
G1 - Region (AZ,CO,KS,NM,OK,TX,UT)
H1 - Region (AK,CA,HI,ID,NV,OR,WA)
VS - (Plate)National Vehicle Service LPR file
NA - (Plate)US Customs and Border Patrol Vehicle LPR file
XX - Unknown